
*Planete i njihovi sateliti
Zemlja=Mesec
Mars=Fobos
Jupiter=Io
Saturn=Titan
Uran=Titania
Neptun=Triton
Pluton=Haron
Merkur=Nema satelit

*Čuveni parovi iz umetnosti
Hamlet=Ofelija
Ruslan=Ljudmila
Zevs=Hera
Otelo=Dezdemona
Paris=Helena
Abelard=Eloiza
Paolo=Frančeska
Lanselot=Ginevra

*Latinski pojmovi
Kvalifikacija=Osposobljenost
Karantin=Izolacija
Radijacija=Zračenje
Ratifikacija=Potpisivanje
Racionalan=Razuman
Reakcija=Otpor
Realizacija=Ostvarenje
Rekapitulacija=Ponavljanje

*Poveži aktuelne predsednike sa državama u kojima vladaju.
Trajan Basesku=Rumunija
Karolos Papuljas=Grčka
Đorđo Napolitano=Italija
Tomas Hendrik Ilves=Estonija
Danilo Tirk=Slovenija
Dimitris Hristofias=Kipar
Tarja Halonen=Finska
Meri Mekelis=Irska

*Francuski gradovi
Bordeaux=Bordo
Auxerre=Okser
Toulouse=Tuluz
Nantes=Nant
Marseille=Marselj
Dijon=Dižon
Limoges=Limož
Chateauroux=Šatero

*Spoji reke i gradove na njihovim obalama
Kolubara=Lazarevac
Timok=Zaječar
Neretva=Mostar
Sava=Šabac
Drina=Zvornik
Dunav=Smederevo
Bosna=Doboj
Vrbas=Bugojno

*Stonoteniseri - države
Timo Boll=Nemačka
Wang Hao=Kina
Oh Sang Eun=Koreja
Jorgen Persson=Švedska
Schlager Werner=Austrija
Kreanga Kalinikos=Grčka
Andrej Gaćina=Hrvatska
A. Karakašević=Srbija

*Povezite proizvođače motorcikala sa zemljom odakle potiču
Ducati=Italija
IZH=Rusija
JAWA=Češka
KTM=Austrija
Triumph=UK
Tomos=Slovenija
Honda=Japan
NSU=Nemačka
Harley-Davidson=SAD

*Povezati sa mestom atentata
Džon Kenedi=Dalas
Franc Ferdinand=Sarajevo
Benazir Buto=Ravalpindi
Mihailo Obrenović=Beograd
Ulof Palme=Stokholm
Abraham Linkoln=Vašington
Indira Gandi=Nju Delhi
Martin Luter King=Memfis

*Povezite poznate muzicke festivale sa zemljama u kojima se nalaze
Sziget=Mađarska
Spirit Of Burgas=Bugarska
Frequency=Austrija
Big Day Out=Australija
Exit=Srbija
Fuji Rock=Japan
Glastonbury=Engleska
Pinkpop=Holandija

*Detektivi i autori
Šerlok Holms=Konan Dojl
Herkul Poaro=Agata Kristi
Inspektor Megre=Žorž Simenon
Rip Kirbi=Aleks Rejmond
Filip Marlou=Rejmond Čendler
Sem Spejd=Dašiel Hamet
Erast Fandorin=Boris Akunjin
Hoze Torente=Santjago Segura

*Grupe i pesme
Haustor=Šal od svile
Azra=Usne vrele višnje
Ekatarina velika=Par godina za nas
Partibrejkersi=Hoću da znam
Električni orgazam=Nebo
Divlje jagode=Kap po kap
YU grupa=Dunavom šibaju vetrovi
Riblja Čorba=Amsterdam
Zabranjeno pušenje=Ibro dirka
Bijelo dugme=Ako ima boga
Prljavo kazalište=Crno bijeli svet
Šarlo aktobata=Niko kao ja
Indeksi=Žute dunje
Idoli=Maljčiki
Film=Kad si mlad
Videosex=Detektivska priča
Zana=Mladiću moj
Lačni Franz=Čakaj me
Buldožer=Žene i muškarci
Psihomodo Pop=Frida

*Kompozitori i njihove opere
Verdi=Don Karlos
Pučini=Manon Lesko
Peri=Dafne
Leonkavalo=Pajaci
Maskanji=Kavalerija Rustikana
Rosini=Seviljski Berberin
Belini=Norma
Doniceti=Lučija od Lamermura

*Nazivi mernih jedinica
energija=džul
količina supstance=mol
električni naboj=kulon
električni potencijal=volt
električna provodljivost=simens
električni kapacitet=farad
sila=njutn
pritisak=paskal

*Latinski pojmovi
Procedura=Postupak
Proklamacija=Oglašavanje
Profesija=Zanimanje
Profit=Prihod
Progres=Napredak
Prohibicija=Zabrana
Prolongirati=Odložiti
Proporcija=Razmera

*Jezera i države
Balaton=Mađarska
Garda=Italija
Veter=Švedska
Ladoga=Rusija
Alarkon=Španija
Van=Turska
Enare=Finska
Deri=Irska
Sevan=Jermenija
Bohinj=Slovenija

*Glagolski oblici
piši=imperativ
rekosmo=aorist
pritrčaćete=futur
nemam=prezent
ne biste znali=potencijal
plačući=glag.prilog sadašnji
videvši=glag. prilog prošli
sastavljahu=imperfekat

*Sazvežđa - latinski i srpski nazivi
Aquarius=Vodolija
Crux=Južni krst
Cygnus=Labud
Canis Minor=Mali pas
Aquila=Orao
Pisces=Ribe
Corona Borealis=Severna kruna
Ursa Minor=Mali medved

*Sazvežđa i zvezde u njima
Veliki pas=Sirijus
Devica=Spika
Mali medved=Severnjača
Orion=Betelgez
Orao=Altair
Lav=Regulus
Blizanci=Kastor
Bik=Aldebaran

*Banje i najbliži gradovi
Zvonačka=Pirot
Gornja Trepča=Čačak
Rusanda=Zrenjanin
Selters=Mladenovac
Vrdnik=Novi Sad
Gamzigradska=Zaječar
Sokobanja=Aleksinac
Ždrelo=Petrovac na Mlavi

*Banje i najbliži gradovi
Junaković=Apatin
Koviljača=Loznica
Bukovička=Aranđelovac
Jošanička=Raška
Prolom=Kuršumlija
Ovčar=Čačak
Mataruška=Kraljevo
Sijarinska=Medveđa

*Fudbalski reprezentativci
Vladimir=Stojković
Branislav=Ivanović
Neven=Subotić
Dejan=Stanković
Milan=Jovanović
Danko=Lazović
Nikola=Žigić
Nenad=Milijaš

*Povežite gradove na L sa državama u kojima se nalaze 
Lisabon=Portugalija
Lanjang=Kina
Larisa=Grčka
Leskovac=Srbija
Liverpul=Engleska
Lugano=Švajcarska
Livno=BiH
Lavov=Ukrajina

*Latinski pojmovi
Prezentacija=Prikaz
Presija=Pritisak
Pretenzija=Namera
Prevencija=Predupređivanje
Primarni=Glavni
Prioritet=Prvenstvo
Privatnost=Intimnost
Privilegija=Povlastica

*Junaci 
Gas=Pepeljuga
Aurora=Uspavana lepotica
Abu=Aladin
Ljutko=Snežana
Vojvotkinja=Mačke iz visokog društva
Zvončica=Petar Pan
Flauder=Mala sirena
Felin=Bambi

*Filmovi braće Koen
Barton=Fink
Veliki=Lebovski
Arizona=Junior
Milerovo=raskršće
Gangsterska=petorka
Spaliti=posle čitanja
Ozbiljan=čovek
Krvavo=prosto

*Spoji dela i njihove pisce
Ivo Andrić=Ex ponto
Laza Lazarević=Švabica
Aleksandar Puškin=Evgenije Onjegin
Desanka Maksimović=Krvava bajka
Branko Ćopić=Čudesna sprava
P.P.Njegoš=Luča mikrokozma
Aleksandar P.Čehov=Tuga
Branko Radičević=Kolo

*Spoji poznate ljude i njihova zanimanja!
Šekspir=Pisac
Gandi=Političar
Tesla=Fizičar
Gagarin=Astronaut
Van Gog=Slikar
Betoven=Kompozitor
Sokrat=Filozof
Polanski=Režiser

*Dobitnici Oskara i njihove uloge
Marlon Brando=Na dokovima Njujorka
Danijel Dej-Luis=Moje levo stopalo
Denzel Vošington=Dan obuke
Džejms Kegni=Jenki Dudl Dendi
Džeremi Ajrons=Obrt sudbine
Piter Finč=TV mreža
Klark Gejbl=Dogodilo se u noći
Gregori Pek=Ubiti pticu rugalicu

*Latinski pojmovi
Pedantan=Uredan
Percepcija=Opažanje
Perfektan=Savršen
Perfidan=Podmukao
Perforirano=Probušeno
Plural=Množina
Popularan=Omiljen
Predator=Grabljivica

*Dobitnice Oskara i njihove uloge
Barbra Strejsend=Smešna devojka
Vivijen Li=Tramvaj zvani želja
Mari Dresler=Min i Bil
Holi Hanter=Klavir
Dajen Kiton=Klavir
Šarliz Teron=Čudovište
Džoan Kraford=Mildred Pirs
Meril Strip=Sofijin izbor

*Režiseri i njihovi poznati filmovi
Pedro Almodovar=Pričaj sa njom
Klint Istvud=Mostovi okruga Medison
Džejn Kempion=Klavir
Martin Skorseze=Dvostruka igra
Aki Kaurismaki=Čovek bez prošlosti
Mihail Haneke=Učiteljica klavira
Roberto Benjini=Život je lep
Stiven Daldri=Čitač

*Poveži junakinje i njihove stvaraoce
Goran Petrović=
Petar Kočić=
Laza Lazarević=
Ivo Andrić=
Dobrica Ćosić=
A. P. Čehov=
Bora Stanković=
Meša Selimović=

Sonja
Mrguda
Anoka
Cveta
Zlatana
Tijana
Mara
Milena

*Spojite imena muzičara sa njihovim pseudonimom
50 cent=
Gru=
Gees brate=
Notorious B.I.G.=
Wikluh Sky=
Delfagor=
Snoop Dogg=
Dr.Dre=

Andre Romelle
Cordozar C. Broadus
Đorđe Miljenović
Curtis J. Jackson
Miloš Božović
Dalibor Andonov 
Christopher Wallace
Slobodan Popović

*Crtani likovi
Veliki štrumpf=Garagmel
Popaj=Badža
Kojot=Ptica trkačica
Silvester=Tviti
Fred=Barni
Skituljko=Pirueta
Vitez Koja=Mlata
Miki=Pluton

*Poznati režiseri i zemlje iz mojih potiču
Liv Ulman=Norveška
Klod Lalus=Francuska
Mihail Haneke=Nemačka
Marlin Goris=Holandija
Robert Altman=SAD
Alfred Hičkok=Velika Britanija
Baz Lurman=Australija
Isijar Boljain=Španija

*Gradovi i reke koje kroz njih protiču
Ivanjica=Moravica
Priboj=Lim
Petrovac=Mlava
Zrenjanin=Begej
Senta=Tisa
Pančevo=Tamiš
Smederevo=Dunav
Čačak=Zapadna Morava

*Staze formule 1 i države u kojima se nalaze
Interlagos=Brazil
Monca=Italija
Šakir=Bahrein
Sepang=Malezija
Herez=Španija
Silverston=Velika Britanija
Suzuka=Japan
Jas Marina=Abu Dabi
Albert Park=Australija
Manji-Kur=Francuske	
Hokenhajm=Nemačka	
Spa Frankošan=Belgija	

*Boje
žuta=minuta
zelena=salata
plava=kamen
bela=tehnika
ljubičasta=ultra
crna=udovica
siva=eminencija
crvena=zvezda

*Oskarovci i njihovi nagrađeni filmovi
Kris Kuper=
Džim Broadbent=
Benisio del Toro=
Džordž Kluni=
Alan Arkin=
Havijer Bardem=
Kristof Valc=
Hit Ledžer=

Mala Mis Sanšajn
Mračni vitez
Nema zemlje za starce
Sirijana
Ajris
Adaptacija.
Prokletnici
Putevi droge

*Oskarovke i njihovi nagrađeni filmovi
Monik=
Marša Gej Harden=
Kejt Blenšet=
Rejčel Vajs=
Dženifer Hadson=
Tilda Sviton=
Penelope Kruz=
Ketrin Zita Džouns=

Brižni baštovan
Dragocena
Devojke iz snova
Majkl Klejton
Čikago
Avijatičar
Ljubav u Barseloni
Polok

*Latinski pojmovi
Orbita=Kružna putanja
Originalni=Izvorni
Oscilirati=Klatiti se
Ovacija=Pohvala
Participacija=Učestvovanje
Pasija=Strast
Pasivan=Neaktivan
Pacijent=Bolesnik

*Oskarovke i njihovi nagrađeni filmovi
Nikol Kidman=Sati
Šarliz Teron=Čudovište
Hale Beri=Bal čudovišta
Hilari Svenk=Devojka od milion dolara
Marion Korijar=Život u ružičastom
Džulija Roberts=Erin Brokovič
Kejt Vinslet=Čitač
Sandra Bulok=Mrtav ugao

*Ljubavne pesme i autori
Čekaj me=Konstantin Simonov
Slovo ljubve=Stefan Lazarević
Anabel Li=Edgar Alan Po
Himna lepoti=Šarl Bodler
Možda spava=Vladislav Petković
Gradinar=Rabindrant Tagore
Šansona=Alfred de Mise
Čežnja=Desanka Maksimović

*Frontmeni i njihove grupe
Džoni Štulić=Azra
Darko Rundek=Haustor
Bora Đorđević=Riblja čorba
Milan Mladenović=Ekatarina Velika
Dražen Žerić=Crvena jabuka
Goran Bregović=Bijelo dugme
Srđan Gojković=Električni orgazam
Vlada Divljan=Idoli

*Pisci i njihova dela
Paulo Koeljo=11 minuta
Slobodan Selenić=Očevi i oci
Nik Hornbi=Sve o dečaku
Meša Selimović=Tvrđava
Dobrica Ćosić=Daleko je sunce
Den Braun=Digitalna tvrđava
Momo Kapor=Ivana
Branko Ćopić=Magareće godine

*Godine i gradovi letnjih olimpijskih igara
london=
peking=
atina=
sidnej=
atlanta=
barselona=
seul=
los anđeles=

1988
1992
2008
1984
2000
2004
1996
2012

*Kom delu pripada koji lik
Rastinjak=
Rodion Romanovič=
Lenski=
Dafina Isakovič=
Mitka=
Ahmet Nurudin=
Abidaga=
Rajka Radaković=

Derviš i smrt
Čiča Gorio
Gospođica
Koštana
Zločin i kazna
Seobe
Na drini ćuprija
Evgenije Onjegin

*Poveži glagole sa glagolskim oblicima 
uradi=imperativ
rekoste=aorist
budeš pročitao=futur II
bi učio=potencijal
gledahu=imperfekat
pitam=prezent
ću raditi=futur I
pisati=infinitiv

*književnici sunarodnici
Knut Hamsun=Henrik Ibzen
Doris Lesing=Agata Kristi
Bret Iston Elis=Perl Bak
Nadin Gordimer=Vilbur Smit
Elfride Jelinek=Peter Handke
Margaret Etvud=Mordekaj Rišler
Benžamen Konstan=Karl Špiteler
Hans Kristijan Andersen=Soren Kjerkegor

*nazivi filmova
Sedam=samuraja
Osam=milimetara
Devet=meseci
Devet i po=nedelja
Deset=malih crnaca
Dvanaest=majmuna
Dvadeset jedan=gram
Trideset devet=stepenika

*Latinski pojmovi
Obligacija=Obaveza
Opscen=Nepristojan
Opstrukcija=Ometanje
Ofanziva=Napad
Oficijelni=Zvanični
Oponent=Protivnik
Optimalan=Najpovoljniji
Orator=Govornik

*Grupe i njihovi frontmeni
Black Sabath=Ozi Ozborn
The Who=Rodžer Daltri
Led Zeppelin=Robert Plant
T-Rex=Mark Bolen
The Doors=Džim Morison
Pink Floyd=Rodžer Voters
AC/DC=Brajan Džonson
Deep Purple=Ian Gilan
Queen=Fredi Merkjuri
Rolling Stones=Mik Džeger
U2=Bono
Guns and Roses=Aksel Rouz
Nirvana=Kurt Kubejn
Aerosmith=Stiven Tajler
Police=Sting
Genesis=Fil Kolins
#http://en.wikipedia.org/wiki/List_of_lead_vocalists

*Svetski rekorderi i njihove discipline
Natalija Lisovskaja=bacanje kugle
Svetlana Masterkova=
Denis Nižegorodov=
Jelena Isinbajeva=skok sa motkom
Julija Pečonkina=trčanje 400m prepone
Vladimir Kanajkin=
Galina Čistjakova=
Olimpiada Ivanova=

trčanje milja
skok u dalj
hodanje 20 km m.
hodanje 50 km
hodanje 20 km ž.


*zapovednici vojski i bitke koje su izgubili
Oskar Poćorek=Kolubarska bitka
Napoleon=Bitka kod Lajpciga
Bajazit I=Bitka kod Angore
Isoroku Jamamoto=Bitka kod Midveja
Vukašin Mrnjavčević=Marička bitka
Kserks I=Bitka kod Salamine
Robert Li=Bitka kod Getizburga
Marko Antonije=Bitka kod Akcija

*Poveži pripadajuće delove
Brod=Jarbol
Lokomotiva=Dimnjak
Automobil=Auspuh
Veš mašina=Programator
Avion=Rep
Podmornica=Periskop
Bicikl=Pedala
Kamera=Sočivo

*Knjige i pisci
Hari Poter=Dž.K.Rouling
20000 milja po morem=Žil Vern
3 musketara=Aleksandar Dima
Vinetu=Karl Maj
Don Kihot=?igel de Servantes
Bela Griva=Rene Gijo
Alisa u zemlji čuda=Luis Kerol
Frankenštajn=Meri Šeli

*Sportski tereni (unurašnji deo) i njihove dužine u metrima
tenis=23.78m
košarka=28m
odbojka=18m
rukomet=40m
vaterpolo=30m
bejzbol=27.5m
ragbi=100m
hokej na ledu=61m

*Povezati dobitnike Nobelove nagrade za književnost sa delima i godinama
Rabindranat Tagore=Gitandzali - '11
Tomas Man=Budenbrokovi - '29
Vilijam Fokner=Uljez u prašini- '49
Ernest Hemingvej=Starac i more - '54 
Boris Pasternak=Doktor Živago - '58
Ivo Andrić=Na Drini ćuprija-'61
Mihail Šolohov=Tihi Don - '65
G. G. Markes=100 godina samoće - '82

*gradovi i njihovi poštanski brojevi
vranje=17500
loznica=15300
kikinda=23300
bačka topola=24300
vršac=26300
gornji milanovac=32300
smederevo=11300
kula=25230

*Najpoznatije elektro grupe i njihovi hitovi
The Prodigy=
Chemical Brothers=
Propellerheads=
Lunatic Calm=
Faithless=
Art Of Noise=
Crystal Method=
Underworld=

Spybreak!
Get Yourself High
Keep Hope Alive
Born Slippy
Mass Destruction
Moments In Love
Leave You Far Behind
Voodoo People

*Latinski pojmovi
Naracija=Pripovedanje
Nacija=Narod
Navigacija=Upravljanje
Nobles=Plemstvo
Nominacija=Kandidatura
Nonsens=Besmislica
Nukleus=Jezgro
Nutritivan=Hranljiv

*Povežite gradove i reke na kojima se nalaze:
Njujork=Hadson
Vašington=Potomak
Pariz=Sena
Nant=Loara
Rim=Tibar
Firenca=Arno
Prag=Vltava
Brno=Svitava

*Glumci i istorijske ličnosti koje su glumili u filmovima
Filip S. Hofman=Truman Kapoti
Leonardo Di Kaprio=Hauard Hjuz
Džejmi Foks=Rej Čarls
Forest Vitaker=Idi Amin
Džoni Dep=Džejms Metju Bari
Morgan Frimen=Nelson Mandela
Entoni Hopkins=Pablo Pikaso
Džozef Fajns=Vilijam Šekspir

*Reditelji i filmovi
Denis Hoper=Goli u sedlu
Dejvid Linč=Čovek slon
Stenli Kjubrik=Lolita
Alfred Hičkok=Prozor u dvorište
Bili Vajlder=Bulevar sumraka
Martin Skorceze=Taksista
Roman Polanski=Kineska četvrt
Džon Hjuston=Afrička kraljica

*Režiseri i filmovi
Džon Hjuston=
Alfred Hičkok=
Ridli Skot=
Klint Istvud=
Metju Kasovic=
Džejms Kameron=
Teri Gilijem=
Dejvid Finčer=

Ambis
Ozloglašena
Blejd Raner
12 majmuna
Malteški soko
Sedam
Mistična reka
Purpurne reke

*Strani bendovi i njihove pesme
Iron Maiden=The Trooper
Scorpions=Send me an angel
The Doors=Riders on the storm
Nightwish=Planet hell
Led Zeppelin=Stairway to heaven
RHCP=Californication
Rolling Stones=Angie
Styx=Boat on the river

*Imena i prezimena domaćih glumaca
Nenad=Jezdić
Boris=Milivojević
Voja=Brajović
Josif=Tatić
Sergej=Trifunović
Branko=Cvejić
Marko=Nikolić
Nebojša=Glogovac

*Ko šta kaže
mačka=mjau
pas=vau
ovca=be
krava=mu
guska=ga
patka=kva
magarac=nja
deda mraz=srećna nova godina

*Ugao između kazaljki na satu i vreme
0 stepeni=12:00
90 stepeni=03:00
180 stepeni=18:00
60 stepeni=14:00
30 stepeni=13:00
120 stepeni=16:00
165 stepeni=00:30
15 stepeni=06:30

*Spojte teniserke sa njihovim drzavljanstvom:
Na Li=Kina
Venus Vilijams=Amerika
Karolina Voznjacki=Danska
Žastin Enan=Belgija
Elena Dementijeva=Rusija
Aravan Rezai=Francuska
Ana Ivanović=Srbija
Marija Sančez=Španija

*planine u državama
Srbija=Golija
Grčka=Olimp
Španija=Pirineji
Bugarska=Rila
Rusija=Ural
Crna Gora=Orjen
Bosna i Hercegovina=Romanija
Slovenija=Julijski Alpi

*Glavne uloge
Hemfri Bogart=Kasablanka
Klint Istvud=Dobar, los, zao
Kevin Kostner=Ples sa vukovima
Marlon Brando=Na dokovima Nju Jorka
Pit Selers=Pink Panter
Geri Kuper=Tačno u podne
Dastin Hofman=Kramer protiv Kramera
Al Paćino=Miris žene

*Bendovi i njihove pesme
Depeche Mode=Personal Jesus
Pet Shop Boys=West End Girls
Duran Duran=Come Undone
Tears For Fears=Shout
Queen=Bohemian Rhapsody
The Police=Roxanne
R.E.M.=The One I Love
Scorpions=Wind of Change

*Latinski pojmovi
Mobilan=Pokretan
Motivacija=Podstrek
Multiplikacija=Množenje
Municija=Streljivo
Mural=Slika na zidu
Muskulatura=Mišićavost
Mutacija=Promena
Moral=Etika

*grupe i gradovi iz kojih potiču
Galija=Niš
Magazin=Split
Makadam=Podgorica
Amajlija=Novi Sad
Osvajači=Kragujevac
Crvena jabuka=Sarajevo
Idoli=Beograd
Leb i sol=Skoplje

*Povežite slavne glumice sa njihovim pravim imenima:
Vupi Goldberg=Kerin Džonson
Lorin Bekol=Beti Džoan Perske
Džin Harlou=Harlin Karpenter
Rita Hejvort=Margarita Kansino
Džindžer Rodžers=Virdžinija MekMat
Suzan Sarandon=Suzan Tomaling
Šer=Šerilin Sarkisijan
Džudi Garland=Franses Etel Gam

*Povežite poznate muzičare sa njihovim pravim imenima:
Elton Džon=Redžinald K. Dvajt
Igi Pop=Džejms N. Osterberg 
Bono Voks=Pol Dejvid Hjuson
Džoni Roten=Džon Džozef Lidon
Adam Ant=Stjuart Lesli Godard
Alis Kuper=Vinsent D. Furnije
Madi Voters=MekKinli Morganfild
Englbert Hamperdink=Arnold Džordž Dorsi

*Poznati muzičari i njihove grupe
Tom Rowlands=Chemical Brothers
Serj Tankian=System Of A Down
Tom Morello=R.A.T.M.
Liam Howlett=The Prodigy
Johny Rotten=Sex Pistols
Till Lindeman=Till Lindeman
Kool Keith=Ultramagnetic MC's
Dave Gahan=Depeche Mode

*Pesme o balkanu
Milan Stanković=Ovo je Balkan
Azra=Balkane moj
Toše Proeski=Žena Balkanska
Magazin=Balkanska ulica
Posled. igra leptira=Grudi balkanske
Zana=Balkanska
Đorđe Balašević=Balkanski Tango
Rambo Amadeus=Balkan boy

*Povežite gitariste sa bendovima:
Adrian Smith=Iron Maiden
Jimmy Page=Led Zeppelin
Reb Beach=Whitesnake
Ritchie Blackmore=Deep Purple
Angus Young=AC/DC
Kirk Hammet=Metallica
Dave Mustaine=Megadeth
David Gilmour=Pink Floyd

*Povežite pevače sa bendovima u kojima nastupaju ili su nastupali:
Robert Plant=Led Zeppelin
Ozzy Osbourne=Black Sabbath
Klaus Meine=Scorpions
Geoff Tate=Queensrÿche
Roger Daltrey=The Who
Bruce Dickinson=Iron Maiden
Brian Johnson=AC/DC
James Hetfield=Black Sabbath

*pevaci i pesme
Riblja Čorba=Amsterdam
Galija=Kotor
Pankrti=Sarajevo 84
Zabranjeno pušenje=Zenica bluz
Leb i sol=Skoplje
Parni valjak=Zagreb ima isti pozivni
Zdravko Čolić=April u Beogradu
Đorđe Balašević=Budimpeštanski sneg

*pevači i pesme
Bajaga i Instruktori=Ruski voz
Zdravko Čolić=Stanica Podlugovi
Zana=Vlak
Bjelo dugme=Tramvaj kreće
Riblja Čorba=Zadnji voz za Čačak
Zabranjeno pušenje=Odlazi voz
Nervozni poštar=Voz za sreću
Dragan Laković=Ivin voz

*Latinski pojmovi
Melanholija=Tuga
Melodija=Napev
Membrana=Opna
Mentalni=Duhovni
Mentor=Savetnik
Migracija=Seoba
Militantan=Ratoboran
Mizerija=Beda

*Animirani likovi i strip junaci i njihovi pratioci
Zagor Tenej=Čiko
Blek Stena=Rodi
komandant Mark=Blaf i Žalosna Sova
kapetan Miki=Smuk i Salos
Lolek=Bolek
Piksi=Diksi
Alan Ford=sir Oliver
vitez Koja=Mlata

*pesnici i njihove pesme
Sergej Jesenjin=Pesma o keruši
Desanka Maksimović=Strepnja
Oskar Davičo =Srbija
Aleksa Šantić=Emina
Hajnrih Hajne=Lorelaj
Šarl Bodler=Albatros
Jovan Dučić=Podne
Stevan Raičković=Nebo

*Povezite imena i prezimena domacih glumaca
Miodrag=Petrović
Branko=Cvejić
Irfan=Mensur
Miki=Manojlović
Vuk=Kostić
Vojin=Ćetković
Marinko=Madzgalj
Stevo=Žigon

*Automobili
Peugeot=Hoggar
Renault=Twingo
Citroen=Berlingo
Fiat=Bravo
Opel=Astra
Lada=Niva
Seat=Ibiza
Honda=Civic

*Narodne poslovice
Ludi boj biju,=a mudri vino piju.
Zid ruši vlaga,=a čoveka briga.
Ko nije služio,=ne zna ni zapovedati.
Što danas ne potrošiš=to si stekao.
Koja se ne rekne,=ona se ne čuje.
Ispeci,=pa reci.
Oteto,=prokleto.
Prvo skoči,=pa kaži hop.

*Ko je s kim u srodstvu/braku
Goldi Hon=Kejt Hadson
Frensis F. Kopola=Nikolas Kejdž
Voren Biti=Širl MekLejn
Džon Vojt=Anđelina Džoli
Martin Šin=Emilio Estevez
Neda Spasojević=Isidora Minić
Svetlana Bojković=Katarina Žutić
Čarli Čaplin=Una O Nil

*Spojte nazive filmova
Blistavi=um
Petparačke=priče
Američka=pita
Apokalipsa=danas
Emetov=beleg
Šindlerova=lista
Zatvoreno=ostrvo
Šesto=čulo

*Pesme i izvođači
Vlado Georgiev=Ako ikad ostarim
Aleksandra Radović=Srce na dlan
Sergej Ćetković=Pogledi u tami
Sasa Kovačević=Ludak
Jelena Tomašević=Jutro
Željko Joksimović=Stihija
Željko Samardžić=Grlica
Marija Šerifović=Bol do ludila

*Imena i prezimena glumica :
Vesna=Trivalić
Branka=Katić
Dara=Džokić
Anita=Mančić
Jelisaveta=Sablić
Olivera=Marković
Ljiljana=Blagojević
Gala=Videnović

*Latinski pojmovi
Maliciozan=Zloban
Maltretirati=Zlostavljati
Malverzacija=Zloupotreba
Manifestacija=Ispoljavanje
Manuelni=Ručni
Marginalan=Nebitan
Matriks=Kalup
Mediokritet=Osrednjost

*pisci i njihova dela
Ernest Hemingvej=Imati i nemati
Milan Kundera=Usporavanje
Amin Maluf=baldasarevo putešestvije
Orhan Pamuk=Sneg
Andre Žid=Podrumi Vatikana
Sol Belou=Humboltov dar
Mihail Šolohov=Uzorana ledina
Alber Kami=Pobunjeni čovek

*Iz koje zemlje su sledeći fudbalski timovi
Genk=Belgija
Boca Juniors=Argentina
Orlando Pirates=Južna Afrika
Malme=Švedska
Young Boys=Švajcarska
FC Copenhagen=Danska
Đer=Mađarska
Larissa=Grčka

*Znamenitosti
Sacre Coeur=Pariz
Karlov most=Prag
Brandenburska kapija=Berlin
Krivi toranj=Piza
Akropolj=Atina
Big Ben=London
Aja Sofija=Istanbul
Milenijski spomenik=Budimpešta

*poznati reprezentativci u različitim sportovima
Nataša Bojković=Šah
Anđelija Arbutina=Košarka
Aranka Binder=Streljaštvo
Tanja Petrović=Karate
Snežana Pajkić=Atletika
Nataša Bokal=Skijanje
Tatjana Ječmenica=Tenis
Maja Bulatović=Rukomet

*Sedišta upravnih okruga u Srbiji
Subotica=Severnobački
Užice=Zlatiborski
Kruševac=Rasinski 
Priština=Kosovski 
Gnjilane=Kosovskopomoravski
Sombor=Zapadnobački
Jagodina=Pomoravski
Leskovac=Jablanički

*Pevači i grupe
Axl Rose=
Brajan Džonson=
Ian Gillan=
Ozi Ozborn=
Robert Plant=
Dejvid Koverdejl=
Brus Dikinson=
Kurt Kobejn=

Black Sabbath
Nirvana
Whitesnake
Iron Maiden
Guns N' Roses
AC/DC
Deep Purple
Led Zeppelin

*PAROVI
ADAM=EVA
BORO=RAMIZ
KAIN=AVELJ
MIRKO=SLAVKO
STANLIO=OLIO
TOM=DŽERI
PAJA=JARE
TIHI=PRLE

*Povezi pesme sa izvođačima
Cowboys from hell=
Back in black=
Flight of icarus=
Fireball=
Seek and destroy=
Hangar 18=
Chinese democracy=
Immigrant song=

Pantera
Guns N' Roses
Metallica
Iron Maiden
AC/DC
Led Zeppelin
Deep Purple
Megadeth

*DOMACE ROCK PESME
Daire=Smak
Ostaću slobodan=Riblja Čorba
Kreni prema meni=Partibrejkers
Glasno, glasnije=Osmi Putnik
Jako srce udara=Osvajači
220 u voltima=Bajaga i Instruktori
Fap mašina=Rambo Amadeus
Na raskršću=Kerber

*pobednici Vimbldona
Boris Beker=
Ričard Krajiček=
Džon Mekinro=
Lejton Hjuit=
Štefan Edberg=
Andre  Agasi=
Džimi Konors=
Pit Sampras=

1998
1982
1988
1986
1984
1996
2002
1992

*Latinski pojmovi
Labilan=Nepostojan
Lapsus=Greška
Latentan=Skriven
Levitacija=Lebdenje
Leksikon=Rečnik
Limitirati=Ograničiti
Likvidan=Tečan
Likvidirati=Uništiti

*ExYu rok - pesme i izvođači
Sarajevo=EKV
Nemir i strast=Azra
Egoista=Riblja čorba
Večeras=Partibrejkers
Stanje šoka=Zabranjeno pušenje
Od zlata jabuka=YU grupa
Talasna dužina=Leb i sol
U vremenu horoskopa=Atomsko sklonište


*Države i kontinenti (regije)
Centralna Amerika=Trinidad
Južna Amerika=Surinam
Severna Amerika=Grenland
Evropa=Andora
Azija=Šri Lanka
Severna Afrika=Tunis
Okeanija=Nova Gvineja
Južna Afrika=Malavi

*Glavni gradovi Afrike
Zimbabve=Harare
Čad=Ndajmena
Madagaskar=Antanarivo
DR Kongo=Kinšasa
Egipat=Kairo
Libija=Tripoli
Kenija=Najrobi
Sudan=Kartum

*proizvođači i glavni proizvodi
Lenovo=Kompjuteri
Carl Zeiss=Optika
Isuzu=Automobili
Patek Philippe=Satovi
Ducati=Motocikli
Swarovski=Nakit
Goldwell=Kozmetika
Microsoft=Softver

*Povezi pesme sa izvodjacima:
Parni valjak=Sve jos miriše na nju
Crvena jabuka=Dirlija
Plavi orkestar=Suada
Zana=Vejte snegovi
U škripcu=Siđi do reke
Riblja čorba=Dva dinara druže
Zdravko Čolić=Sinoć nisi bila tu
Magazin=Minus i plus

*Domaći pisci i dela
Danilo Kiš=
Branko Ćopić=
Miloš Crnjanski=
Borislav Pekić=
Ivo Andrić=
Meša Selimović=
Momo Kapor=
Stevan Sremac=

Halo, Beograd
Tvrđava
Bašta sljezove boje
Pop Ćira i pop Spira
Besnilo
Roman o Londonu
Aska i vuk
Peščanik

*glavne uloge
robert de niro=
kevin costner=
dastin hofman=
marlon brando=
džejms din=
majkl daglas=
edi marfi=
al paćino=

istocno od raja
lice s ožiljkom
fatalna privlačnost
na dokovima njujorka
ples sa vukovima
taksista
otkaceni profesor
diplomac

*Lekovi i dejstva
Antiaritmici=za srce
Analgetici=protiv bolova
Antibiotici=protiv bakterija
Antimikotici=gljivične infekcije
Antikoagulansi=protiv tromboze
Antiseptici=za čiščenje
Kontraceptivi=za kontracepciju
Anestetici=depresija CNSa

*Povezite pevace sa njihovim pesmama
Justin Timberlake=Cry me a river
The Rasmus=No Fear
Linkin Park=Crawling
Evanescence=Going under
Muse=Time Is Running Out
Shakira=Objective Tango
Nightwish=Nemo
RHCP=Californication

*Latinski pojmovi
Introvertan=
Intuicija=
Invazija=
Investicija=
Ironija=
Iracionalan=
Irigacija=
Iritirati=

Nerazuman
Povučen
Razdražiti
Poruga
Predosećaj
Ulaganje
Navodnjavanje
Najezda

*Pesme evrovizije
Lys Assia=Refrain
Sandie Shaw=Puppet on a String
ABBA=Waterloo
Johnny Logan=Hold Me Now
Riva=Rock Me
Dana International=Diva
Ruslana=Wild Dances
Marija Šerifović=Molitva

*Najviši objekti u svetu
Burj Khalifa=Emirati
CN Tower=Kanada
Ostankino Tower=Rusija
Empire State Building=SAD
Petronas Twin Towers=Malezija
Taipei 101=Tajvan
Q1=Australija
Oriental Pearl Tower=Kina

*Poveži pisce sa njihovim delima
Ivo Andrić=
Petar Kočić=
Branislav Nušić=
Branko Radičević=
Aleksa Šantić=
Desanka Maksimović=
Branko Ćopić=
Džek London=

Đački rastanak
Mostovi
Moja otadžbina
Srebrne plesačice
Beli očnjak
Sumnjivo lice
Pohod na mjesec
Grob slatke duše

*Pevači i pesme narodne muzike
Tozovac=Oči jedne žene
Toma Zdravković=Kiša je padala
Marinko Rokvić=Zamiriši na brazdu
Keba=Zapaliću pola grada
Slavko Banjac=Daleko negde ko zna
Mile Kitić=Kraljica trotoara
Šaban Šaulic=Kraljica mog srca
Milan Babić=Neveni

*Ratarske kulture - latinski nazivi
Kukuruz=Zea Mays
Pšenica=Triticum Species
Ječam=Hordeum Sativum
Šećerna Repa=Beta Vulgaris
Suncokret=Helianthus Annuus
Krompir=Solanum Tuberosum
Mrkva=Daucus Carota
Ovas=Avena Sativa

*Slikari i njihova dela
Pablo Pikaso=Dečak sa lulom
Piter Paul Rubens=Masakr nevinih
Gustav Klimt=Portret Adele Bloh
Pol Sezan=Kartaši
Hijeronimus Boš=Rajski vrt
Vinsent van Gog=Irisi
Vasilij Kandinski=Plavi jahač
Pit Mondrian=Foxtrot A

*Biološke discipline
Botanika=Biljke
Zoologija=Životinje
Morfologija=Građa organizama
Histologija=Tkiva
Genetika=Nasledne osobine
Mikologija=Gljive
Citologija=Ćelije
Mikrobiologija=Mikroorganizmi

*Pevacice i pesme narodne muzike
Dragana Mirković=Umirem majko
Gordana Stojičević=Pala ćuprija
Vesna Zmijanac=Kazni me
Lepa Brena=Robinja
Mira Škorić=Niz vene tiho tečeš
Zorica Brunclik=Evo već je Božić
Snežana Đurišić=Imena mi mog
Ana Bekuta=Kralj ponoći

*Latinski pojmovi
Insinuacija=
Insistirati=
Inspekcija=
Inspiracija=
Instinkt=
Instrukcija=
Interakcija=
Interval=

Uputstvo
Nagoveštaj
Raspon
Nagon
Zahtevati
Nadahnuće
Uzajamni uticaj
Nadzor

*povežite imena i prezimena sportista
Ana=
Nikola=
Ivan=
Filip=
Nađa=
Ivana=
Jelena=
Danko=

Grbić
Janković
Španović
Filipović
Higl
Miljković
Lazović
Ivanović

*Glumci, glumice i filmovi
Džejms Din=
Bred Pit=
Gari Sinis=
Tom Henks=
Rene Zelveger=
Nikol Kidman=
En Hatavej=
Rejf Fajns=

Zelena milja
Vojvotkinja
Sati
Rejčel se udaje
Istočno od raja
Upoznajte Džo Bleka
Truman
Empire Records

*Reke i gradovi
Kostolac=Dunav
Kosovska Mitrovica=Ibar
Kruševac=Rasina
Valjevo=Gradac
Bajina Bašta=Drina
Kanjiža=Tisa
Zrenjanin=Begej
Sarajevo=Miljacka

*Klub i država..
Engleska=Manchester
Španija=Villareal
Francuska=PSG
Portugalija=Sporting
Italija=Lacio
Rusija=CSKA
Srbija=Crvena Zvezda
Holandija=PSV

*Sportisti Srbije
Ivan=Miljković
Dejan=Stanković
Dušan=Kecman
Filip=Filopović
Nikola=Grbić
Nemanja=Vidić
Miloš=Teodosić
Andrija=Prlainović

*Povezite fudbalske trenere 
Alex=Ferguson
Jose=Mourinho
Carlo=Ancelotti
Radomir=Antić
Pep=Guardiola
Roberto=Mancini
Rafael=Benitez
Goran=Stevanović

*Glumci
Vilis=Brus
Harelson=Vudi
Berindžer=Tom
Kristal=Bili
Pen=Šon
Istvud=Klint
Marfi=Edi
Šerbedžija=Rade

*Spojite marke sa njihovim parfemima
B.U.=Blossom
Naomi Campbell=At night
Lacoste=Inspiration
Rich=New Brand
Fruttini=Cherry vanilla
Playboy=Pink
Hypnose=Lancome
Escada=Sentiment 

*Imena i prezimena kompozitora
Johan Sebastijan=Bah
Karl Marija=Veber
Volfgang Amadeus=Mocart
Georg Fridrih=Hendl
Modest=Musorgski
Bedžih=Smetana
Stevan Stojanović=Mokranjac
Ludvig van=Betoven

*Likovi i dela
Kreont=Antigona
Andreas Sam=Rani jadi
Džon Kori=Ostrvo šljiva
Raskoljnikov=Zločin i kazna
Ron Vizli=Hari Poter
Merkucije=Romeo i Julija
kardinal Rišelje=Tri musketara
Enkidu=Gilgameš

*Knjige i autori
Periodični sistem=Primo Levi
Iskonski strah=Viljem Dil
Ime ruže=Umberto Eko
Ostrvo šljiva=Nelson de Mil
Apsolutna moć=Dejvid Baldači
San=Agata Kristi
Baukov šegrt=Džozef Dilejni
Ajnštajnova devojka=Filip Sington

*Gradovi i države
Osaka=Japan
Nant=Francuska
Koč=Mađarska
Sumbe=Angola
Rabat=Maroko
Liberec=Češka
Krakov=Poljska
Jerevan=Jermenija

*Spojite pojmove sa oblastima
Bezuov stav=matematika
Keplerovi zakoni=fizika
Protolitička teorija=hemija
Skovilova skala=kulinarstvo
metonimija=književnost
Boforova skala=meteorologija
Vajc-Zekerova teorija=geografija
Sfumato tehnika=slikarstvo

*Spojite prezimena sa zanimanjima; ime je Goran
Tešić=
Bregović=
Ivanišević=
Knežević=
Višnjić=
Nikolić=
Petrović=
Sultanović=

matematičar
košarkaš
političar i košarkaš
hrvatski glumac
muzičar
srpski glumac
teniser
pisac

*Volim te na europskim jezicima
Ti amo=italijanski
Je t´aime=francuski
Te quiero=španski
I love you=engleski
Eu te amo=portugalski
Te iubesc=rumunski
Ich liebe dich=nemački
S'ayapo=grčki

*Volim te na europskim jezicima
Te dua=albanski
Miluji te=češki
Lubim ta=slovački
Ljubim te=slovenački
Kocham cie=poljski
Ya tebe kokhayu=ukrajinski
Ya tyebya lyublyu=ruski
Obicham te=bugarski

*Volim te na europskim jezicima
Ik hou van je=holadski
Mina armastan sind=estonski
Mina rakastan sinua=finski
Es tevi milu=letonski
Jeg elsker deg=norveški
Jag alskar dig=švedski
Jeg elsker dig=danski
Sizi seviyorum=turski
Szeretlek=mađarski
# http://www.translatum.gr/etexts/i-love-you.htm

*Latinski pojmovi
Indikacija=
Indirektan=
Indolencija=
Infekcija=
Inferioran=
Infuzija=
Inicijalni=
Inovacija=

Ukazivanje
Ulivanje
Zaraza
Podredjen
Posredan
Novina
Lenjost
Početni

*ruski književnici i njihova dela
Maksim Gorki=
Sergej Jesenjin=
Mihail Ljermontov=
Fjodor Dostojevski=
Nina Berberova=
Dmitrij Kuzmin=
Josif Brodski=
Lav N. Tolstoj=

Lepo je biti živ
Breza
Junak našeg doba
Stanica u pustinji
Mati
Ana Karenjina
Zločin i kazna
Knjiga o sreći

*Grupe i imena njihovih pevača
Stone Temple Pilots=Skot Vajlend
System of a Down=Serj Tankijan
Talking Heads=Dejvid Birn
Tool=Majnard Džejms Kinan
Vampire Weekend=Ezra Kenig
Weezer=Rajvers Kuomo
The Who=Rodžer Delatrej
Red Hot Chili Peppers=Entoni Kidis

*Spojite poznatu braću i prezimena
Rajt (Wright)=Vilbur i Orvil
Limije (Lumiere)=Džoel i Itan
Grim (Grimm)=Jakob i Vilhelm
Tarabić=Miloš i Mitar
Koen (Coen)=Džoel i Itan
Teofilović=Radiša i Ratko
Karamazov=Ivan i Aljoša
Warner=Albert i Hari

*Vladari i period njihove vladavine
Viktorija I=
Napoleon=
Miloš Obrenović=
Mihailo Obrenović=
A.Karađorđević=
Milan Obrenović=
Mahmud II=
Nikolaj I Romanov=

1868-1889
1837-1901
1825-1855
1842-1858
1799-1815
1839-1842
1808-1839
1858-1860

*Internet domeni
.int=
.mil=
.museum=
.name=
.net=
.eu=
.pro=
.travel=

međunarodne organizacije
lica iz Evropske unije
pojedinci
mreže
vojni
turističke organizacije
muzeji
profesije

*Grupe i imena njihovih pevača
Joy Division=Jan Kartis
Led Zeppelin=Robert Plant
Metallica=Džejms Hetfild
Pixies=Blek Frencis
Queen=Fredi Merkjuri
Radiohead=Tom Jork
The Rolling Stones=Mik Džeger
Sex Pistols=Džon Lidon

*Grupe i imena njihovih pevača
Blur=Dejmon Albern
Bon Jovi=Džon Bon Džovi
The Clash=Džo Stramer
Coldplay=Kris Martin
The Doors=Džim Morison
Foo Fighters=Dejv Grol
Franz Ferdinand=Aleks Kapranos
Journey=Stiv Peri

*Poveži nazive dela sa njihovim autorima:
U registraturi=Ante Kovačić
Sidarta=Herman Hese
Starac i more=Ernest Hemingvej
Hadži-Murat=Tolstoj
Tvrđava=Meša Selimović
Bedni ljudi=Miroslav Krleža
Gospoda Glembajevi=Miroslav Krleža
Prokleta avlija=Ivo Andrić

*Spojite knjige i likove iz tih knjiga
Grof Monte Kristo=Edmond Dantes
Ana Karenjina=Ljevin
Mobi Dik=Kapetan Ahab
Orlovi rano lete=Jovanče
Robinzon Kruso=Petko
Tom Sojer=Hak
Narodni poslanik=Jevrem Prokić
Tvrdica=Harpagon

*Latinski pojmovi
Imperija=Carstvo
Imperativ=Zapovest
Import=Uvoz
Impresija=Utisak
Inkarnacija=Otelotvorenje
Incest=Rodoskrnavljenje
Incident=Ispad
Inkriminišući=Optužujući

*Košarkaši
milan=
nemanja=
dejan=
dušan=
uroš=
predrag=
marko=
dragan=

kićanović
kešelj
tripković
mačvan
bodiroga
bjelica
kecman
danilović

*film
erin brokovich=
loši momci=
muž na iznajmljivanje=
poslednji templar=
poslednji provod=
hari poter=
oko sokolovo=
paukova zavera=

morgan frimen
saja labaf
kvin latif
julia roberts
mario lopez
will smith
mira sorvino
danijel redklif

*Povežite političare i njihove stranke:
Boris Tadić=DS
Vojislav Koštunica=DSS
Dragan Marković=JS
Jovan Krkobabić=PUPS
Velimir Ilić=NS
Aleksandar Vučić=SNS
Mlađan Dinkić=URS
Vojislav Šešelj=SRS
Čedomir Jovanović=LDP
Nenad Čanak=LSV
Ivica Dačić=SPS
Vuk Drašković=SPO
Rasim Ljajić=SDPS

*TV kanali i zemlje iz kojih potiču
Kanal RI=
OBN=
TVPika=
Kopernikus=
Atlas TV=
Kanal 5=
Duna=
TVRi=

Hrvatska
Makedonija
Srbija
Crna Gora
BiH
Rumunija
Slovenija
Mađarska

*Rukometaši
jovanović=
bojinović=
vujović=
škrbić=
ilić=
perić=
nikolić=
butulija=

dejan
mladen
veselin
ratko
nedeljko
igor
dragan
momir

*Nazivi filmova u originalu i na našem jeziku
La belle et la bete=Lepotica i zver
La vita e bella=Život je lep
Lola rennt=Trči, Lola, trči
Todo sobre mi madre=Sve o mojoj majci
Hable con ella=Pričaj s njom
Ying xiong=Heroj
Nochnoy dozor=Noćna smena
Cidade de Deus=Božji grad

*Autor i naziv knjige
Svetislav Basara=Kinesko pismo
Milan Oklopdžić=CA Blues
Dušan Kovačević=20 srpskih podela
Filip Gajić=Pisma Danilu Kišu
Milorad Pavić=Predeo slikan čajem
Miodrag Bulatović=Peti prst
Vladimir Arsenijević=U potpalublju
Igor Mirković=Sretno dijete

*naslovi filmova
crveni=
crni=
beli=
plavi=
trinaesti=
sedmi=
drugi=
prvi=

grom
zmaj
ratnik
pečat
greh
zečevi
čovek
biseri

*Imena i prezimena novinara
Brankica=Stanković
Vladimir=Jelić
Zoran=Stanojević
Dragoljub=Žarković
Dragan=Bujošević
Slobodan=Šarenac
Veran=Matić
Jugoslav=Ćosić
Teofil=Pančić

*TENISERI
SODERLING=
VILANDER=
LENDL=
SAMPRAS=
AGASI=
KANJAS=
VERDASKO=
VAVRINKA=

PIT
FERNANDO
ANDRE
MATS
ROBIN
IVAN
STANISLAS
GILJERMO

*Titovi gradovi u vreme SFRJ
Vojvodina=Vrbas
Srbija=Užice
Kosovo=Mitrovica
Crna Gora=Titograd
BiH=Drvar
Makedonija=Veles
Hrvatska=Korenica
Slovenija=Velenje

*slike i slikari
rođenje venere=
isus svetog ivana=
smrt i maske=
peglerke=
glava u glavi=
dve mačke=
porodica karla IV=
mandril=

franc mark
sandro botičeli
oskar kokoška
edvard munk
salvador dali
edgar dega
francisko goja
dzejms ensor

*prezimena i imena glumica
janjić=
stipić=
šargin=
jakšic=
štrljić=
kolačaric=
vranješ=
bogdanovic=

natasa
danijela
iva
nada
jovana
lena
marija
sonja

*Televizijski kanali (programi)
fox=crime
discovery=science
animal=planet
national=geographic
arena=sport
zone=reality
dm=sat
studio=b

*TENISERKE
RADVANSKA=
ZVONARJEVA=
KUZNJECOVA=
KLAJSTERS=
ENAN=
BARTOLI=
PENETA=
BAMER=

KIM
AGNJEŠKA
ŽASTIN
MARION
SIBIL
SVETLANA
FLAVIJA
VERA

*prezimena i imena reditelja
balabanov=
tarkovski=
mihalkov=
paradžanov=
lungin=
bauer=
žilnik=
makavejev=

želimir
branko
andrej
dušan
sergej
nikita
pavle
aleksej

*filmovi i režiseri
milioner iz blata=
dvostruka igra=
čikago=
gladijator=
ples sa vukovima=
eni hol=
forest gamp=
blistavi um=

vudi alen
ron hauard
martin skorceze
deni bojl
kevin kostner
ridli skot
rebert zemekis
rob maršal

*TENISERI
ANDREJEV=
SAFIN=
DAVIDENKO=
STEPANEK=
BERDIH=
ČENG=
BEKER=
MEKINRO=

RADEK
DŽON
MAJKL
BORIS
IGOR
MARAT
NIKOLAJ
TOMAŠ

*TENISERKE
NAVRATILOVA=
SANČEZ=
PETROVA=
AZARENKA=
ČAKVETADZE=
DEMENTIJEVA=
PIRONKOVA=
SAFAROVA=

JELENA
MARTINA
LUSI
ANA
ARANČA
VIKTORIJA
CVETANA
NAĐA

*Spojite imena autora sa nazivima dela
Ivo Andrić=
Meša Selimović=
Laza Lazarević=
Radoje Domanović=
Petar Kočić=
Miloš Crnjanski=
Dobrica Ćosić=
Branko Ćopić=

Vođa
Vreme smrti
Jablan
Tvrđava
Aska i vuk
Švabica
Magareće godine
Seobe

*Latinski pojmovi
Identičan=
Ignorisati=
Ilegalan=
Iluzija=
Imitacija=
Imigrant=
Imobilisati=
Imunitet=

Izbegavati
Učvrstiti
Useljenik
Varka
Oponašanje
Protivzakonit
Otpornost
Istovetan

*Povezite imena i prezimena poznatih ličnosti
Novak=
Dragan=
Milena=
Emir=
Goran=
Zdravko=
Eva=
Ita=

Kusturica
Dravić
Nikolić
Bregović
Ras
Čolić
Rina
Đoković

*Spojite izvođače sa pesmama
HIM=
Rammstein=
Evanescence=
Placebo=
Metallica=
Marilyn Manson=
Red Hot ChiliPeppers=
Nirvana=

This picture
Can't stop
Enter sandman
Ohne dich
Wicked game
My immortal
Lithium
Tainted love

*Države i njihovi glavni gradovi 
Budžumbura=
Kairo=
Kanbera=
Karakas=
Kastrijes=
Kišinjev=
Pariz=
Konakri=

Venecuela
Gvineja
Moldavija
Francuska
Burundi
Egipat
Australija
Sveta Lusija

*Aerodromi u evropi
zagreb=
london=
rim=
beograd=
madrid=
budimpešta=
milano=
kopenhagen=

barajas
castrup
feriheđ
nikola tesla
heathrow
pleso
malpensa
fiumicino

*Politicke partije u Srbiji i njihovi predsednici
LDP=
SPS=
SNS=
DS=
DSS=
SRS=
G17+=
LSV=

Vojislav Šešelj
Čedomir Jovanović
Nenad Čanak
Vojislav Koštunica
Ivica Dačić
Boris Tadić
Mlađan Dinkić
Tomislav Nikolić

*Predsednici država
Hrvatska=
Crna Gora=
SAD=
Rusija=
Ukrajina=
Venecuela=
Libija=
Francuska=

Ivo Josipović
Ugo Čavez
Dmitrij Medvedev
Viktor Janukovič
Filip Vujanović
Nikola Sarkozi
Barak Obama
Moamer el Gadafi

*Filmovi i reditelji
Sedmi pečat=
Uvećanje=
Sanjari=
Ptice=
Anđeo uništitelj=
Nostalgija=
Nebo nad Berlinom=
Rašomon=

Bergman
Venders
Hičkok
Tarkovski
Bunjuel
Bertoluči
Antonioni
Kurosava

*Države i njihovi glavni gradovi 
Brazilija=
Bratislava=
Brazavil=
Bridžtaun=
Brisel=
Bukurešt=
Budimpešta=
Buenos Ajres=

Rumunija
Brazil
Argentina
Belgija
Slovačka
Barbados
Mađarska
Republika Kongo

*Imena i prezimena narodnih pevača
Sinan=
Miroslav=
Marinko=
Mitar=
Dragan=
Jašar=
Ljuba=
Radiša=

Ilić
Aličić
Ahmedovski
Mirić
Kojić
Rokvić
Urošević
Sakić

*povezite glumce sa filmovima u kojima su glumili
Titanik=
Pirati sa Kariba=
Dežurni krivci=
Troja=
Hrabro Srce=
Prljavi Hari=
Pink Panter=
Gladiator=

Mel Gibson
Rasel Krou
Klint Istvud
Bred Pit
Džoni Dep
Leonardo di Kaprio
Stiv Martin
Kevin Spejsi

*Poveži latinske izreke i njihovo značenje:
Amor vincit omnia!=
Acta, non verba!=
Carpe diem!=
Cogito,ergo sum.=
Divide et impera!=
In vino veritas.=
Homo homini lupus.=
Sapienti sat.=

U vinu je istina.
Pametnome dosta.
Dela, ne reči!
Ljubav sve pobeđuje!
Zavadi pa vladaj!
Mislim,daklepostojim
Čovek je čoveku vuk.
Iskoristi dan!

*Države i njihovi glavni gradovi 
Baku=
Bamako=
Bandar Seri Begavan=
Bangkok=
Bangvi=
Bandžul=
Basetere=
Peking=

Centralnoafrička rep
Kina
Gambija
Tajland
Mali
Azerbejdžan
Sveti Kits i Nevis
Brunei

*Države i njihovi glavni gradovi 
Antananarivo=
Apija=
Ašgabat=
Asmara=
Astana=
Asunsion=
Atina=
Bagdad=

Eritreja
Madagaskar
Kazahstan
Paragvaj
Irak
Turkmenistan
Grčka
Samoa

*Ličnosti i njihovi konji
Marko Kraljević=
Don Kihot=
Damjan Jugović=
Aleksandar Veliki=
Vojvoda Momčilo=
Talični Tom=
Miloš Obilić=
Kaligula=

Šarac
Džoli Džamper
Bukefal
Jabučilo
Rosinante
Incitatus
Zelenko
Ždralin

*Latinski pojmovi
Gratis=
Gravidnost=
Habitus=
Halucinacija=
Harmonija=
Hegemonija=
Hibernacija=
Homogenizacija=

Besplatno
Zimski san
Prividjenje
Prevlast
Sklad
Stanište
Trudnoća
Ujednačavanje

*Poznati filmski parovi
Telma=
Boni=
Starski=
Tango=
Šrek=
Gospodin Smit=
Stanlio=
Betmen=

Keš
Luiz
Fiona
Gospođa Smit
Robin
Hač
Olio
Klajd

*Pobednici evrovizije i pesme
marija serifovic=
elena paparizu=
dana international=
riva=
abba=
ruslana=
lordi=
toto cutugno=

hard rock halellujah
wild dance
my number one
insieme
rock me
diva
waterloo
molitva

*iz koje su zemlje teniseri
lejton hjuit=
robin soderling=
endi marej=
ivo karlović=
radek stepanek=
markos bagdatis=
fernando verdasko=
viktor troicki=

srbija
španija
češka
australija
velika britanija
švedska
hrvatska
kipar

*iz koje su zemlje teniserke
elena dementieva=
flavia peneta=
ameli morezmo=
agnjeska radvanska=
samanta stosur=
viktorija azarenka=
katarina bondarenko=
jelena janković=

srbija
ukrajina
australija
rusija
francuska
italija
poljska
belorusija

*Grupe i pesme
Smak=
Divlje jagode=
EKV=
Tutti Frutti Band=
Neki to vole vruće=
Kerber=
Indexi=
Alisa=

Krug
Jedina moja
Bacila je sve niz rijeku
Kesten
Ja bih da pevam
Između jave i sna
Ne bojim se drugova 
Daire

*Poznati golmani
Edvin=Van der Sar
Iker=Kasiljas
Jens=Leman
Viktor=Valdes
Oliver=Kan
Žulije=Cezar
Vladimir=Stojković
Petr=Čeh

*Istorija
Napoleon Bonaparte=Francuska
Džordž Vašington=SAD
Stefan Prvovenčani=Srbija
Julie Cezar=Stari Rim
Ramzes II=Egipat
Wellington=Engleska
Adolf Hitler=Nemačka
Petar Veliki=Rusija

*Gde su rođene sledeće ličnosti:
Zdravko Čolić=Sarajevo
Lepa Brena=Brčko
Savo Milošević=Bijeljina
Miroslav Ilić=Mrčajevci
Nemanja Vidić=Užice
Jelena Karleuša=Beograd
Nenad Čanak=Pančevo
Boris Isaković=Novi Sad

*Velike bitke u 19 veku
1815=Vaterlo
1804=Čokešina
1813=Lajpcig
1805=Trafalgar
1809=Čegar
1806=Mišar
1853=Krim
1812=Borodino

*Povezite tenisere i drzave odakle su rodjeni
Stanislav Vavrinka=Švajcarska
Fernando Verdasko=Španija
Novak Đoković=Srbija
Endi Rodik=SAD
Žil Simon=Francuska
David Nalbandian=Argentina
Lejton Hjuit=Australija
Mihail Južnji=Rusija

*Povezite pevačice sa njihovim pesmama
Britney Spears=Circus
Tina Tarner=Simply The Best
Madonna=Like a Virgin
Whitney Houston=I will always love you
Lady Gaga=Poker Face
Cascada=Everytime we touch
Rihanna=Umbrella
Celine Dion=My heart will go on

*Povezite građevine sa državama
Petra=Jordan
Ajfelov toranj=Francuska
Koloseum=Italija
Čičen Ica=Meksiko
Stounhendž=Velika Britanija
Maču Piču=Peru
Kremlj=Rusija
Aja Sofija=Turska
Borobudur=Indonezija
Tadž Mahal=Indija
Sagrada Familija=Španija
Burdž al Arab=UAE

*Latinski pojmovi
Galantnost=
Geneza=
Glamur=
Glorifikacija=
Globalno=
Gradacija=
Graciozna=
Granulacija=

Raskoš
Usitnjavanje
Uglađena
Svetsko
Uglađenost
Nastanak
Uzdizanje
Stepenovanje

*Spoji zanimanja
Svetozar Gligorić=Šahista
Snežana Pajkić=Atletičarka
Svetislav Basara=Pisac
Svetozar Stojanović=Filozof
Siniša Pavić=Scenarista
Svetislav Goncić=Glumac
Slobodan Vuksanović=Političar
Svetlana Kitić=Rukometašica

*Spojiti države i gradove
Makedonija=Kavadarci
Crna gora=Berane
Hrvatska=Koprivnica
Slovenija=Ptuj
Nemačka=Hanover
Mađarska=Pečuj
Albanija=Drač
Grčka=Pirej

*Fudbaleri i nacionalnosti
Fabian Bartez=Francuska
Oliver Kan=Nemačka
Filipo Inzagi=Italija
Jap Stam=Holandija
Džejmi Karager=Engleska
Robi Kin=Irska
Hasan Salihamidžić=BiH
Leonel Mesi=Argentina

*Poveži gradove i države
Lion=Francuska
Finiks=SAD
Moskva=Rusija
Sao Paolo=Brazil
Barselona=Španija
Solun=Grčka
Puebla=Meksiko
Montreal=Kanada

*Poveži pesmu sa izvođačem
The Beatles=
AC/DC=
Led Zeppelin=
Nirvana=
Deep Purple=
Metallica=
Cream=
Sound Garden=

Hush
Spoon Man
Sad but true
Dumb
Highway to hell
Help
Sunshine of my love
Black Dog

*Rock izvođači i pesme
billy idol=
scorpions=
g'n'r=
whitesnake=
aerosmith=
bon jovi=
bryan adams=
led zeppelin=

is this love
patience
always somewhere
crazy
run to you
livin' on a prayer
stairway to heaven
sweet sixteen

*Spojite turcizme sa srpskim nazivima
harač=
zulum=
ašik=
tefter=
ligure=
kadija=
đuvegija=
divit=

nasilje
mladoženja
sudija
beležnica
sanke
ljubav
mastionica
porez

*Poveži pevače sa bendom u kome pevaju
Vlada Divljan=
Bora Đorđević=
Jan Gilan=
Robert Plant=
Juro Stublić=
Vlatko Stefanovski=
Saša Lošić=
Stiven Tayler=

Leb i Sol
Riblja Čorba
Deep Purple
Plavi Orkestar
Idoli
Aerosmith
Led Zepellin
Film

*pevaci i njihove pesme
Toše Proeski=
Sergej Ćetković=
Dino Merlin=
Vlado Georgijev=
Željko Samardžić=
Kemal Monteno=
Al Dino=
Bojan Marović=

2 minuta
Kopriva
Nije htjela
Tropski bar
9000
10 mladja
Kao oči tvoje
Iluzija

*Antonimi
Sreća=
Gore=
Bitan=
Akceleracija=
Analiza=
Apstrakcija=
Indukcija=
Pro=

Usporavanje
Dedukcija
Sinteza
Dole
Tuga
Nevažan
Kontra
Konkretizacija

*Sinonimi
Tuga=
Verovatno=
Astal=
Otoman=
Vokabular=
Akceleracija=
Edukacija=
Erudita=

Ubrzanje
Moguće
Sto
Obrazovanje
Seta
Svestran
Krevet
Rečnik

*Grupe i njihove numere
Kerber=
Bijelo dugme=
Piloti=
Azra=
Smak=
Atomsko sklonište=
Crvena Jabuka=
Zana=

Marina
Tuga,ti i ja
Plava pesma
Da te bogdo ne volim
Medena
Čini mi se da
Jabuke i vino
Devojka broj 8

*Pevači i  njihove numere
Zdravko Čolić=
Oliver Dragojević=
Oliver Mandić=
Vlado Georgijev=
Dino Dvornik=
Dino Merlin=
Sasa Kovačević=
Željko Samardžić=

Ako me ikada sretneš
Manijaci
Grlica
Hipnotiziran
Vjeruj u ljubav
Žena bez imena
Mila
Hoću samo tebe

*Grupe i njihove numere
Whitesnake=
The Doors=
Led Zeppelin=
Deep Purple=
The Who=
The Free=
Iron Maiden=
Metallica=

L.A. Woman
Run to the hills
All right now
When a blind man cries
My generation
Black dog
Enter Sandman
Is this love

*Glumice i filmovi
Salma Hajek=
Džulija Roberts=
Nikol Kidman=
Šeron Stoun=
Penelope Kruz=
Kira Najtli=
Kejt Vinslet=
Ema Votson=

Niske strasti
Dim
Otvori oči
Osmeh Mona Lize
Desperado
Duhovi u nama
Hari Poter
Gordost i predrasude

*Glumci i filmovi
Brus Vilis=Boja noći
Endi Garsija=Nesalomivi
Al Paćino=Serpiko
Antonio Banderas=Veži me
Bred Pit=Troja
Džoni Dep=Tajni prozor
Harison Ford=Zaposlena devojka
Džordž Kluni=Solaris

*Vrste reči
Jer=
Veoma=
Dobar=
Misao=
Onakav=
Od=
Hiljada=Broj
Trčati=Glagol

Predlog
Prilog
Imenica
Pridev
Zamenica
Veznik

*Latinski pojmovi
Fraktura=
Fragment=
Frekvencija=
Frigidna=
Frontalni=
Frustracija=
Furiozan=
Fuzija=

Prelom
Silovit
Čeoni, Prednji
Učestalost
Odlomak
Spajanje
Ravnodušna
Razočaranje

*Košarkaši
Milenko=Tepić
Dejan=Bodiroga
Dražen=Dalipagić
Dragan=Kićanović
Vlade=Divac
Predrag=Danilović
Željko=Rebrača
Kosta=Perović

*Regije Italije- Glavni gradovi
Abruco=L'Akvila
Apulija=Bari
Bazilikata=Potenca
Kalabrija=Katancaro
Kampanija=Napulj
Emilija-Romanja=Bolonja
Furlanija-Julijska krajina=Trst
Lacio=Rim
Ligurija=Đenova
Lombardija=Milano
Marke=Ankona
Molize=Kampobaso
Pijemont=Torino
Sardinija=Kaljari
Sicilija=Palermo
Toskana=Firenca
Umbrija=Peruđa
Veneto=Venecija
#http://sr.wikipedia.org/sr-el/%D0%90%D0%B4%D0%BC%D0%B8%D0%BD%D0%B8%D1%81%D1%82%D1%80%D0%B0%D1%82%D0%B8%D0%B2%D0%BD%D0%B0_%D0%BF%D0%BE%D0%B4%D0%B5%D0%BB%D0%B0_%D0%98%D1%82%D0%B0%D0%BB%D0%B8%D1%98%D0%B5

*Spoji ime i prezime tenisera
Rafael=Nadal
Roger=Federer
Ilija=Bozoljac
Endi=Rodik
Tomaš=Berdih
Nikolaj=Davidenko
Tomi=Has
Novak=Đoković

*Imena fudbalera
Nikola=Žigić
Samuel=Eto
Miloš=Krasić
Didier=Drogba
Dejvid=Bekam
Lionel=Mesi
Petr=Čeh
Andrea=Pirlo

*Gradovi i države u kojima se oni nalaze
Francuska=Lion
Nemačka=Minhen
Švajcarska=Bern
Austrija=Grac
Španija=Barselona
Italija=Palermo
Grčka=Atina
Egipat=Memfis

*Sport
Danilo Ikodinović=vaterpolo
Nikola Lazetić=
Olivera Jevtić=
Alisa Marić=
Aleksandar Đorđević=
Milorad Čavić=plivanje
Tadija Kačar=
Jelena Janković=tenis

boks
atletika
fudbal
košarka
šah

*Glumice
Milena=
Špela=
Olga=
Ljljana=
Svetlana=
Danica=
Rahela=
Ljerka=

Lašić
Ferari
Bojković
Rozin
Dravić
Spiridonović
Draženović
Maksimović

*slikari i njihova dela
Karavađo=
Mone=
Da Vinči=
Mark Rotko=
Pikaso=
Sezan=
Rembrant=
Van Gog=

meduza
mrtva priroda sa zelenom dinjom
beli centar
gernika
regate u arzanteju
žuta kuca
dama sa jagnjetom
jevrejska mlada

*slikari i njihova dela
Salvador Dali=
Edvard Munk=
Emil Nolde=
Endi Vorhol=
Ezen Delakroa=
Francisko Goja=
Gustav Kurbe=
Kamij Pisaro=

kestenje u osni
tucači kamena
sloboda predv. nar.
postojanost pamćenja
sveti simeon i žene
nemir
havarija zelen. kola
3. maj 1808.

*Francuski kompozitori-ime i prezime
Hektor=Berlioz
Kamij=Sen-Sans
Žak=Ofenbah
Žil=Masne
Žorž=Bize
Fransoa=Kupren
Frederik=Šopen
Klod=Debisi

*Latinski pojmovi
Fiksirati=
Fleksibilnost=
Fluktuacija=
Fokus=
Forma=
Formalno=
Fortuna=
Frakcija=

Centar
Delić
Zvanično
Sreća
Učvrstiti
Savitljivost
Kolebanje
Oblik

*Filmovi i njihovi reditelji
Vitorio de Sika=kradljivci bicikala
Federiko Felini=ulica
Andrej Tarkovski=ogledalo
Miloš Forman=kosa
Roman Polanski=stanar
Gus van Sant=slon
Ingmar Bergman=divlje jagode
Akira Kurosava=rašmon

*Znamenitosti
Big Ben=London
Ajfelova kula=Pariz
Krivi Toranj=Piza
Kip Slobode=Njujork
Tadž Mahal=Agra
Karlov Most=Prag
Keopsova piramida=Egipat
Crveni trg=Moskva

*Nadimci fudbalskih klubova
Valensija=Slepi miševi
Atletiko Madrid=Jorgandžije
Viljareal=Žuta podmornica
Udineze=Zebre
Juventus=Stara dama
Everton=Karamele
Vest Hem=Čekićari
Njukasl=Svrake

*Zanimanja poznatih ljudi
Srđan Timarov=
Miloš Teodosić=košarkaš
Ivan Živković=
Vladimir Vermezović=
Zarko Trebješanin=
Dejan Stanković=fudbaler
Danijel Đurić=
Mihajlo Pupin=naučnik

glumac
pevač
psiholog
reditelj
fudbalski trener

*Sportski radio novinari-izveštači :
Jordan=
Marko=
Edo=
Mirko=
Risto=
Ivan=
Jovo=
Miodrag=

Tomić
Stoiljković
Marković
Ivanović
Kubura
Kamenjašević
Jovanović
Peci

*Bokseri...
Fazlija=
Memet=
Marjan=
Mate=
Svetomir=
Zvonko=
Ace=
Slobodan=

Rusevski
Vujin
Beneš
Bogujevci
Kačar
Belić
Parlov
Šaćirović

*Bendovi i njihovi hitovi
Metallica=
AC/DC=
Whitesnake=
Beatles=
Nirvana=
Him =
Nightwish=
Green Day=

Is this love
Highway to hell
Nemo
American idiot
Smells like teen sp.
Solitary man
Yesterday
Nothing else matters

*Pesme i geografski pojmovi
Riblja Čorba=Amsterdam
Neki to vole vruće=Kalifornija
Leb i sol=Skopje
Bajaga=Berlin
Fredi Merkjuri=Barselona
Bi džiz=Masačusets
Toto=Afrika
Bebi Dol=Brazil

*Rimski brojevi
3333=MMMCCCXXXIII
2222=MMCCXXII
1111=MCXI
555=DLV
1010=MX
2008=MMVIII
997=CMXCVII
88=LXXXVIII

*Italijanski pisci-ime i prezime
Dante=Aligijeri
Karlo=Kolodi
Umberto=Eko
Alberto=Moravija
Frančesko=Petrarka
Luiđi=Pirandelo
Đovani=Bokačo
Salvatore=Kvazimodo

*Fabrike i gradovi u Srbiji
Bambi=Požarevac
Medela=Vrbas
Simpo=Vranje
Sunce=Sombor
Knjaz Miloš=Aranđelovac
Marbo Produkt=Maglić
Sloboda=Čačak
Sintelon=Bačka Palanka

*Ličnosti sa imenom Karl i profesije
Jung=Psihijatar
Malden=Glumac
Line=Biolog
Orf=Kompozitor
Lagerfeld=Modni kreator
Bilt=Političar
Meloun=Košarkaš
Gaus=Matematičar

*Gradovi i aerodromi
Nju Jork=JFK
London=Heathrow
Beograd=Nikola Tesla
Los Anđeles=LAX
Tokio=Narita
Moskva=Domodedovo
Sidnej=Kingsford Smith
Johanesburg=O.R. Tambo
Čikago=O'Hare
Paris=Charles de Gaulle
Amsterdam=Schiphol
Madrid=Barajas
Las Vegas=McCarran
Singapore=Changi
Šanghaj=Pudong
Rim=Fiumicino
Istanbul=Atatürk
Zagreb=Pleso
Sarajevo=Butmir
Podgorica=Golubovci
Skoplje=Aleksandar Veliki
Ljubljana=Jože Pučnik
Barcelona=El Prat
Beč=Schwechat
Cirih=Kloten
Berlin=Tegel
Vašington=Dulles
Kuala Lumpur=Sepang
Venecija=Giulia

*Spojiti imena i prezimena naučnika
Gregor=
Karl=
Viliam=
Tomas=
Irvin=
Evelin=
Marta=
Alfred=

Hersi
Čejs
Sargaf
Mendel
Betson
Korens
Morgan
Vitkin

*Vaterpolo klubovi i gradovi iz kojih dolaze?
Mladost=
Primorac=
Jadran=
Jug=
Mornar=
Primorje=
Rokava=
Partizan=

Dubrovnik
Koper
Split
Kotor
Zagreb
Herceg Novi
Beograd
Rijeka

*Košarkaski klubovi i gradovi iz kojih dolaze?
Hemofarm=Vršac
Proleter=Zrenjanin
Tamiš=Pančevo
Partizan=Beograd
Metalac=Valjevo
Vojvodina=Novi Sad
Borac=Čačak
Zdravlje=Leskovac

*Spojite imena i prezimena poznatih nacista:
Jozef=
Herman=
Rudolf=
Martin=
Adolf=
Hajnrih=
Rajnhard=
Oto=

Ditrih
Hajdrih
Ajhman
Gebels
Hes
Gering
Borman
Himler

*Prvi NBA klubovi igrača...
La Lakers=
Chicago Bulls=
Detroit Pistions=
Miami Heat=
San Antonio Spurs=
Boston Celtics=
Portland Trail Blaze=
New Jersey Nets=

Predrag Danilović
Vlade Divac
Žarko Paspalj
Dino Rađa
Nenad Krstić
Darko Miličić
Aleksandar Đorđević
Toni Kukoč

*Atletičari i zemlje iz kojih dolaze?
Hasim el Geruz=
Daniel Komen=
Kenenisa Bekele=
Dajron Robles=
Jusejn Bolt=
Vladimir Kanajkin=
Roman Sebrle=
Tijeri Tuten=

Etiopija
Kenija
Češka
Francuska
Jamajka
Rusija
Kuba
Maroko

*Američki pisci
Džon Apdajk=
Margaret Mičel=
F.Skot Ficdžerald=
Teodor Drajzer=
Sol Belou=
Henri Miler=
Ernest Hemingvej=
Mark Tven=

Američka tragedija
Veliki Getsbi
Prohujalo s vihorom
Žrtva
Zbogom oružje
Rakova obratnica
Kraljević i prosjak
Zekin povratak

*Košarkaški klubovi i zemlje iz kojih dolaze?
Makabi=Izrael
Zadar=Hrvatska
Aris=Grčka
Montepaski=Italija
Valensija=Španija
Prokom=Poljska
Nimburk=Češka
Alba=Nemačka

*Koje životinje su Diznijevi junaci?
Miki Maus=miš
Paja Patak=patak
Horacije=konj
Belka=krava
Pluton=pas
Dambo=slon
Čip=veverica
Daba=mačak

*Pandani windows/linux programa
Winamp=XMMS
Photoshop=Gimp
MS Office=Open Office
Live Messenger=aMSN
uTorrent=KTorrent
Nero Burning Rom=k3b
Internet Explorer=Konqueror
Command Prompt=Konsole

*Vaterpolo klubovi i zemlje iz kojih dolaze?
Mladost=Hrvatska
Partizan=Srbija
Primorac Kotor=Crna Gora
Eger=Mađarska
Barseloneta=Španija
Olimpiakos=Grčka
Spandau 04=Nemačka
Savona=Italija

*Košarkaški treneri:
Bogdan=
Mirko=
Aleksandar=
Ranko=
Željko=
Dušan=
Svetislav=
Krešimir=

Žeravica
Pešić
Obradović
Novosel
Tanjević
Nikolić
Ćosić
Ivković

*Teniseri i njihova imena :
Lejton=
Ivan=
Nikolaj=
Piter=
Goran=
Novak=
Nikola=
Dušan=

Vemić
Pilić
Prpić
Hjuit
Davidenko
Lendl
Sampras
Đoković

*Engleski pisci-imena i prezimena
Džejn=Ostin
Šarlota=Bronte
Luis=Kerol
Agata=Kristi
Danijel=Defo
Virdžinija=Vulf
Čarls=Dikens
Radjard=Kipling

*Latinski pojmovi na E
Entuzijazam=
Epidemija=
Ekvivalentan=
Erupcija=
Eskalacija=
Evakuacija=
Egzaktan=
Ekselencija=

Širenje
Uzvišenost
Iseljavanje
Izbacivanje
Masovna zaraza
Polet
Tačan
Jednak

*Narodni heroji i nadimci :
Josip Broz=
Vladimir Perić=
Slaviša Vajner=
Sava Jovanović=
Fadil Jahić=
Ivo Ribar=
Slobodan Penezić=
Filip Kljajić=

Krcun
Lola
Čiča
Valter
Fića
Španac
Sirogojno
Tito

*Fabrike i gradovi u srbiji
Vital=Vrbas
Jaffa=Crvenka
Voda Vrnjci=Vrnjačka Banja
Banini=Kikinda
Pionir=Subotica
Dijamant=Zrenjanin
Milan Blagojević=Smederevo
Albus=Novi Sad

*Sportisti i njihove reprezentacije
Vladan Grujić=
Ciprian Marica=
Rick Smits=
Shawn Bradley=
Harry Kewel=
Kevin Garnet=
J.R. Holden=
Zoran Savić=

Rumunija
Rusija
USA
Nemačka
Australija
Holandija
Jugoslavija
BiH

*Povežite filmove i glumce oskarovce
Most na reci Kvaj=
Ubiti pticu rugalicu=
Paton=
Gandi=
Moje levo stopalo=
Život je lep=
Mistična reka=
Afrička kraljica=

Ben Kingsli
Džordž K. Skot
Gregori Pek
Danijel Dej Luis
Šon Pen
Roberto Beninji
Hempfri Bogart
Alek Ginis

*Latinski pojmovi
Ekskomunikacija=
Egzekucija=
Egzodus=
Ekspanzija=
Ekspert=
Eksplicitan=
Eksploatacija=
Eksponat=

Isključenje
Iskorišćavanje
Stručnjak
Masovno odseljavanje
Izvršenje
Izložbeni predmet
Širenje
Jasan

*Povežite bitke i datume u Drugom svetskom ratu.
Velika Britanija=
Berlin=
Normandija=
Ivo Džima=
Perl Harbur=
Kursk=
Midvej=
El Alamejn (Prvi)=

10.jul-31.okt. 1940.
3-6.jun 1942.
19.feb.-16.mar. 1945
5.jul-23.avg. 1943.
7. dec. 1941.
6.jun-25.avg. 1944.
16.apr.-2.maj 1945.
1-27. jul 1942.

*Spojite rase pasa i FCI grupe u koje su svrstane.
njufaundlendski pas=
bradati koli=
jorkširski terijer=
samojed=
bigl=
epanjel breton=
malteški pas=
irski vučki hrt=

III
I
IX
X
VI
VII
V
II

*Spojite gitariste i grupe u kojima su nastupali.
Eric Clapton=
Lou Reed=
Yngwie Malmsteen=
Marty Friedman=
Kirk Hammett=
Uli Jon Roth=
Al di Meola=
Ritchie Blackmore=

Rainbow
Return to Forever
Exodus
Blind Faith
Alcatrazz
Velvet Underground
Cacophony
Scorpions

*Spojite književnike sa njihovim delima
Desanka Maksimović=
Oskar Davičo=
Jovan Jovanović Zmaj=
Đura Jakšić=
Vojislav Ilić Mlađi=
Stevan Raičković=
Branko Ćopić=
Branko Radičević=

Vojničko pismo
Kad mlidijah umreti
Septembar
Otadžbina
Srbija
Krvava bajka
Pionirska trilogija
Đulići

*Prava imena glumaca
Kirk Daglas=
Vin Dizel=
Vudi Alen=
Čarli Šin=
Tom Berindžer=
Keri Grant=
Čarlton Heston=
Majkl Kejn=

Arčibald Lič
Mark Sinkler Vinsent
Alen Konigsberg
Džon Karter
Iser Danielovič
Moris Miklvajt
Karlos Estevez
Tomas Mur

*Rok grupe i njihove pesme
Azra=
Smak=
Zabranjeno pušenje=
Atomsko sklonište=
Električni orgazam=
Riblja čorba=
Partibrejkersi=
Kerber=

Poslednja
Mesečeva kći
Kapetan Esid
Pavel
Kanjon Drine
Satelit
Žuti kišobran
Al Kapone

*Spojite tenisere i zemlje iz kojih potiču
Marat Safin=
Gustavo Kuerten=
Endi Marej=
Pit Sampras=
Mark Filipusis=
Robin Soderling=
Novak Đoković=
Markos Bagdatis=

USA
Velika Britanija
Brazil
Australija
Srbija
Svedska
Kipar
Rusija

*Simboli hemijskih elemenata
Gvožđe=
Živa=
Kalaj=
Antimon=
Srebro=
Fosfor=
Zlato=
Astatin=

Au
P
Hg
At
Sb
Sn
Ag
Fe

*NBA legende i klubovi u kojima su najduže igrali
lary bird=
karl malone=
reggie miller=
joe dumars=
ervin johnson=
david robinson=
dominique wilkins=
michael jordan=

l.a. lakers
chicago bulls
san antonio spurs
detroit pistons
utah jazz
boston celtics
atlanta hawks
indiana pacers

*Marke i modeli automobila
rekord=
geo=
ka=
impreza=
1007=
sprinter=
kangoo=
xsara=

opel
mercedes
subaru
peugeot
chery
citroen
ford
renault

*Latinski pojmovi
Ekscentričan=
Eho=
Eklipsa=
Edicija=
Edukacija=
Efekat=
Efikasnost=
Egoizam=

Sebičnost
Učinkovitost
Vaspitanje
Nastran
Pomračenje
Odjek
Izdanje
Dejstvo

*Povezite pisce sa njihovim prezimenima
Dragiša=
Tanasije=
Momčilo=
Stanislav=
Zaharije=
Stevan=
Svetislav=
Filip=

David
Stefanović
Orfelin
Vasić
Nastasijević
Mladenović
Vinaver
Jakovljević

*Koliko su trajali navedeni ratovi
Pelononeski=
Grčko-persijski=
Stogodišnji=
Ratovi ruža=
Vijetnamski=
Drugi svetski=
Šestodnevni=
Prvi svetski=

30 godina
113 godina
50 godina
18 godina
6 dana
6 godina
4 godine
27 godina

*Imena i prezimena francuskih pisaca
Balzak=
Igo=
Vern=
Flober=
Rolan=
Prever=
Dima=
Zola=

Gistav
Onore
Romen
Žak
Emil
Žil
Aleksandar
Viktor

*Ko je bio naš predstavnik na Eurosongu
1986.=
1988.=
1982.=
1992.=
1991.=
1984.=
1990.=
1989.=

Doris Dragović
Tajči
Ekstra Nena
Vlada i Izolda
Bebi Dol
Aske
Srebrna krila
Riva

*Latinski pojmovi
Teror=
Testament=
Tolerancija=
Torzija=
Tortura=
Total=
Transfer=
Transformacija=

Celina
Užas
Preobražaj
Mučenje
Zavet
Upredanje
Prenos
Trpeljivost

*Hemijski elementi
azot=
hlor=
natrijum=
fosfor=
fluor=
sumpor=
hrom=
stroncijum=

Sr
Cr
F
N
Na
Cl
P
S

*Teniseri i nacionalnost, odnosno država iz koje su
Lejton Hjuit=
Artur Eš=
Endi Mari(ej)=
Igor Andrejev=
Boris Beker=
Danijel Nestor=
Viktor Troicki=
Rišar Gaske=

Rusija
Škotska
SAD
Nemačka
Srbija
Kanada
Francuska
Australija

*Imena i prezimena francuskih pisaca
Aragon=
Bodler=
Kami=
Dode=
Apoliner=
Prust=
Žid=
Sand=

Andre
Marsel
Šarl
Žorž
Alfons
Alber
Gijom
Luj

*Osvajači oskara i filmovi
Ingrid Bergman=
Gari Kuper=
Vivijen Li=
Lorens Olivije=
Hemfri Bogart=
Odri Hepbern=
Alek Guins=
Simon Sinjore=

Hamlet  
Gasno svetlo
Afrička kraljica
Praznik u Rimu
Soba na krovu
Prohujalo sa vihorom
Most na reci Kvaj
Narednik Jork

*Latinski pojmovi
Evakuacija=Iseljavanje
Evidentan=Očigledan
Evokacija=Dozivanje
Egzaktan=Tačan
Eskalirati=Intezivirati
Ekselencija=Preuzvišenost
Eksces=Ispad
Ekskurzija=Izlet

*Imena i prezimena holivudskih glumica
Uma=Turman
Sandra=Bulok
Nikol=Kidman
Penelope=Kruz
Skarlet=Johanson
Džesika=Alba
Ešli=Džad
Šarliz=Teron

*Rock grupe i njihovi albumi
Beatles=Help
Rolling Stones=Sticky Fingers
AC/DC=Highway to Hell
Queen=A Night at the Opera
Whitesnake=Ready an' Willing
Led Zeppelin=Houses of the Holy
Deep Purple=Machine Head
Doors=Morrison Hotel

*Slikari i dela
Paja Jovanović=
Uroš Predić=
Petar Lubarda=
Marko Murat=
Nadežda Petrović=
Sava Šumanović=
Stojan Aralica=
Đura Jakšić=

Pijana lađa 
Noćna straža
Kosovka devojka
Ranjeni Crnogorac
Resnik
Cveti
Motiv iz Lošinja
Bitka na Vučjem dolu

*Nacionalnost šahovskih velemajstora
Maks Eve=
Kapablanka=
Emanuel Lasker=
Vilhelm Štajnic=
Bobi Fišer=
Anatolij Karpov=
Bent Larsen=
Tigran Petrosjan=

Austrijanac
Nemac
Kubanac
Amerikanac
Danac
Rus
Jermenin
Holanđanin

*nadimci
Miograg Petrović=
Dragan Stojković=
Vladislav Petković=
Momčilo Bajagić=
Vladimir Petrović=
Vesna Vukelić=
Filipo Inzagi=
Milan Jovanović=

Bajaga
Čkalja
Pižon
Vendi
Lane
Dis
Pipo
Piksi

*Renesansni slikari i dela
Andrea del Verokio=
Jan van Ajk=
Sandro Botičeli=
Rafaelo Santi=
Leonardo da Vinči=
Mikelanđelo=
Ticijan=
Filipo Lipi=

Madona u šumi
Marija Magdalena
Leda i labud
Krštenje Hristovo
Proleće
Muškarac s karanfil
Galateja
Strašni sud

*Južnoamerički glavni gradovi
Ekvador=
Gvajana=
Kolumbija=
Paragvaj=
Peru=
Surinam=
Urugvaj=
Venecuela=

Paramaribo
Kito
Karakas
Lima
Džordžtaun
Asunsion
Montevideo
Bogota

*Valute država
Indija=
Bugarska=
Albanija=
Rumunija=
Gruzija=
Sudan=
Brazil=
Vijetnam=

Lej
Rupija
Lari
Dinar
Dong
Lek
Real
Lev

*Imena poznatih rok gitarista
Wylde=
Blackmore=
May=
Satriani=
Vai=
Darrell=
Gilmour=
Mihailović=

Zakk
David
Steve
Brian
Ritchie
Radomir
Joe
Dimebag

*Jedinice fizičkih veličina
vreme=sekunda
rad=džul
sila=njutn
napon=volt
jačina mag. polja=veber
frekvencija=herc
el. otpor=om
jačina struje=amper

*Prezimena i imena ruskih pisaca
Turgenjev=Ivan
Šolohov=Mihail
Dostojevski=Fjodor
Puškin=Aleksandar
Akunjin=Boris
Jesenjin=Sergej
Tolstoj=Lav
Majakovski=Vladimir

*Latinski pojmovi
Enorman=
Entuzijazam=
Ekvivalentnost=
Erozija=
Erudita=
Eskalacija=
Eskort=
Esej=

Širenje
Ogroman
Književni pokušaj
Naučenjak
Polet
Odron
Pratnja
Jednakost

*Ljudi i životinje
Bojović=
Milan Jovanović=
Vuds=
Tolstoj=
Dario=
Tanja=
Gojko=
Rada Adžić=

Vuk
Medved
Lav
Srna
Lane
Bubamara
Tigar
Zec

*Ninova nagrada
Oskar Davičo=
Miroslav Krleža=
Grozdana Olujić=
Slobodan Selenić=
Danilo Kiš=
David Albahari=
Mirko Kovač=
Aleksandar Tišma=

Beton i svici
Mamac
Prijatelji
Peščanik
Zastave
Upotreba čoveka
Glasovi u vetru
Vrata od utrobe

*okruzi i gradovi
Severnobački=
Srednjobanatski=
Kolubarski=
Šumadijski=
Zaječarski=
Rasinski=
Toplički=
Pčinjski=

Knić
Vladičin Han
Trstenik
Kuršumlija
Mali Iđos
Nova Crnja
Ljig
Sokobanja

*Latinski pojmovi
Aspiracija=
Asimilacija=
Asocijacija=
Atencija=
Atribut=
Aukcija=
Auditorijum=
Averzija=

Rasprodaja
Stapanje
Udruživanje
Publika
Težnja
Odbojnost
Pažnja
Osobina

*glagolski oblici
planirati=
planira=
je planirao=
planiran=
će planirati=
budem planirao=
bi planirao=
planiravši=

glag.pridev trpni
glag.prilog prošli
futur II
potencijal
infinitiv
prezent
perfekat
futur I

*Ratni planovi...
Alarih=
Barbarosa=
Overlord=
Oto=
Tajfun=
Morski lav=
Švarc=
Poduhvat 25=

Napad na V.Britaniju
Napad na SSSR
Desant u Normandiji
5.ofanziva u NOR-u
Okupacija Italije 
Napad na Jugoslaviju
Napad na Austriju
Napad na Moskvu

*vrste reči
igranje=
odmah=
spokojan=
troje=
čemu=
na=
dakle=
ići=

imenica
rečca
zamenica
pridev
prilog
glagol
broj
predlog

*Latinski pojmovi na K
Kognitivan=
Kohabitacija=
Koincidencija=
Kolaboracija=
Kolaps=
Kompaktan=
Komparacija=
Kompenzacija=

Saradnja
Uporedjivanje
Krah
Suživot
Spoznajni
Slučajnost
Nadoknada
Zbijen

*Planete i horoskopski znaci (vladavina)
strelac=
blizanac=
jarac=
vodolija=
ovan=
bik=
rak=
lav=

venera
merkur
saturn
mesec
jupiter
sunce
uran
mars

*Latinski pojmovi
Konveksan=
Kooperacija=
Korelacija=
Korupcija=
Kreacija=
Kulminacija=
Kultivacija=
Kurtoazija=

Ispupčen
Vrhunac
Mito
Tvorevina
Saradnja
Učtivost
Veza
Obrađivanje

*Banje i Gradovi
Mataruška=
Ovčar=
Zvonačka=
Brestovačka=
Rusanda=
Selters=
Bukovačka=
Vrujci=

Čačak
Aranđelovac
Mladenovac
Bor
Melenci
Pirot
Valjevo
Kraljevo

*Likovi iz romana
Ravik=
Žan Velžan=
knez Bolkonski=
Raskoljnikov=
Jozef K.=
grofica Zija Dukaj=
Žilijen Sorel=
Vilijem od Baskervil=

Crveno i crno
Ararat
Rat i mir
Jadnici
Ime ruže
Proces
Zločin i kazna
Trijumfalna kapija

*Književni parovi
Romeo=
Faust=
Raskoljnikov=
Hari Haler=
Dante=
Vronski=
Onjegin=
Hamlet=

Julija
Ana Karenjina
Hermina
Beatriče
Margareta
Ofelija
Sonja
Tatjana

*junaci istog stripa
Mandrak=
Zagor=
Teks Viler=
Blek Stena=
Komadant Mark=
Rip Kirbi=
Harun el Prašid=
Flaš Gordon=

Rodi
Iznogud
Blaf
Čiko
Lotar
Kit Karson
Ming
Dezmond

*pisci i dela
Herman Hese=
Tomas Man=
Franc Kafka=
Ginter Gras=
E.M.Remark=
Hajnrih Bel=
J.Volfgang Gete=
Hajnrih Man=

Grup.portret s damom
Čarobni breg
Zamak
Faust
Sidarta
Profesor Unrat
Limeni doboš
Trijumfalna kapija

*Pesnici i pesme
Jovan Dučić=
Aleksa Šantić=
Milan Rakić=
V.Petković-Dis=
Vasko Popa=
Vojislav Ilić=
Miloš Crnjanski=
Đura Jakšić=

Korintska hetera
Pesma ženi
Otadžbina
Nepočin-polje
Veče na školju
Možda spava
Mizera
Dolap

*Kompozitor i dela
Verdi=
Belini=
Rosini=
Pučini=
Bize=
Vagner=
Mocart=
Betoven=

Tristan i Izolda
Fidelio
Norma
Nabuko
Karmen
Boemi
Otmica iz saraja
Seviljski berberin

*pisci i dela (V. Britanija)
Čarls Dikens=
Šarlota Bronte=
Somerset Mom=
Džon Golsvordi=
Oskar Vajld=
Emili Bronte=
Džejn Ostin=
Viljem Šekspir=

Slika Dorijana Greja
San letnje noći
Orkanski visovi
Saga o Forsajtima
Vilet
Nikolas Niklbi
Gordost i predrasuda
Ljudski okovi

*Glavni gradovi
Novi Zeland=
Kanada=
Indonezija=
Malezija=
Australija=
Kazahstan=
Mongolija=
Nigerija=

Kuala Lumpur
Velington
Kanbera
Astana
Abuja
Džakarta
Ulan Bator
Otava

*Gradovi
Malta=
Kipar=
Libija=
Liban=
Sirija=
Izrael=
Etiopija=
Turska=

La Valeta
Adis Abeba
Damask
Tripoli
Nikozija
Ankara
Bejrut
Tel Aviv

*Velike bitke
Bitka kod Sadove=
Bitka kod Trafalgara=
Bitka na Mohaču=
Bitka kod Isa=
Bitka kod Velbužda=
Bitka na Somi=
Bitka kod Heroneje=
Bitka kod Jorktauna=

1866.godine
338.godine p.n.e.
1330.godine
1526.godine
1805.godine
1781.godine
333.godine p.n.e.
1916.godine

*francuski pisci i dela
Stendal=
Dima stariji=
Flober=
Igo=
Balzak=
Vern=
Zola=
Dima mlađi=

Deca kapetana Granta
Tri musketara
Madam Bovari
Žerminal
Parmski kartuzijansk
Dama s kamelijama
Čovek koji se smeje
Čiča Gorio

*Ruski pisci i dela
Dostojevski=
L.Tolstoj=
Puškin=
Turgenjev=
Gogolj=
Čehov=
Šolohov=
Gorki=

Uzorana ledina
Višnjik
Kapetanova kći
Vaskrsenje
Makar Čudra
Taras Buljba
Plemićko gnezdo
Zli dusi

*Šahisti
Hoze Raul Kapablanka=
Pol Morfi=
Fridrih Olafson=
Višvanatan Anand=
Maks Eve=
Bent Larsen=
Albin Planinc=
Leonid Štajn=

Indija
SSSR
Danska
Slovenija
Kuba
SAD
Island
Holandija

*partneri
Starski=
Stanlio=
Molder=
Džej=
Šerlok Holms=
Han Solo=
Frodo=
Vitez Koja=

Mlata Zamlata
Sem
Dr. Votson
Hač
Skali
Olio
Tihi Bob
Čubaka

*POJMOVI NA SLOVO "A"
ABDIKACIJA=
AMNESTIJA=
AUTOKEFALNOST=
AMNEZIJA=
ASTIGMATIZAM=
ANOMALIJA=
AVERZIJA=
AGITACIJA=

CRKVENA SAMOSTALNOST
POMILOVANJE
ODBOJNOST
LOBIRANJE
DEFORMITET OKA
POREMEĆAJ
GUBITAK PAMĆENJA
ODRICANJE OD VLASTI

*atleticarke i zemlje iz kojih dolaze
vilma rudolf=
ema grin=
suzana fejtor=
keli holms=
inesa kravec=
barbara spotakova=
svetlana masterkova=
veronika kembel=

Ukrajina
Jamajka
Češka
Velika Britanija
Švedska
SAD
Rusija
Portugal

*Popularni likovi iz filmova
Doroti Gejl=
Don Vito Korleone=
Luk Skajvoker=
Džon Konor=
Elen Ripli=
Skarlet O'hara=
Vilijam Valas=
Hanibal Lektor=

Kad jaganjci utihnu
Hrabro srce
Osmi putnik
Čarobnjak iz Oza
Ratovi zvezda
Kum
Terminator
Prohujalo s vihorom

*Prezimena i imena velikih naučnika
Tesla=
Nobel=
Mendeljejev=
Njutn=
Lagranž=
Ajnštajn=
Bor=
Ojler=

Isak
Nikola
Žozef-Luj
Albert
Leonard
Dmitrij
Nils
Alfred

*Popularni likovi iz crtanih filmova
Splinter=
Ariel=
Vendi=
Simba=
Gargamel=
Đepeto=
Gorbaš=
Džafar=

Mala sirena
Let zmajeva
Pinokio
Kralj lavova
Štrumpfovi
Petar Pan
Aladin
Nindža kornjače

*Fizičke veličine i njihove merne jedinice
dužina=metar
masa=kilogram
snaga=vat
pritisak=paskal
vreme=sekunda
energija=džul
temperatura=kelvin
jačina svetlosti=kandela

*Srpski gradovi na rekama:
Užice=Đetinja
Kosovska Mitrovica=Ibar
Zaječar=Timok
Kragujevac=Lepenica
Bečej=Tisa
Ćuprija=Velika Morava
Zrenjanin=Begej
Valjevo=Kolubara

*Srpski gradovi na rekama:
Kruševac=Rasina
Trstenik=Zapadna Morava
Zaječar=Timok
Šabac=Sava
Loznica=Drina
Novi Pazar=Raška
Aleksinac=Južna Morava
Prijepolje=Lim
Pirot=Nišava

*Afričke države - sticanje nezavistnosti
Džibuti=
Gana=
Somalija=
Sudan=
Burundi=
Libija=
Eritreja=
Angola=

1993
1951
1957
1975
1956
1960
1962
1977

*Redosled po udaljenosti od Sunca (1 je najbliža):
Venera=
Mars=
Merkur=
Neptun=
Jupiter=
Zemlja=
Uran=
Saturn=

8
2
5
3
6
1
7
4

*Rok pesme
Toto=
Bruce Springsteen=
Michael Jackson=
Bryan Adams=
Mike Oldfield=
David Bowie=
Frank Sinatra=
Ultravox=

Have you ever really loved a woman
Vienna
Little China girl
New York, New York
Africa
St. of Philadelphia
Liberian girl
Get to France

*Rok pesme
Neki to vole vruće=
Dado Topić=
Dino Dvornik=
Sladjana Milošević=
Idoli=
Bebi Dol=
YU Grupa=
Bajaga=

Amsterdam
Dunave
Rusija
Na Balkanu
Kalifornija
Afrika
Berlin
Brazil

*rok pesme
Azra=
Aerodrom=
ITD Band=
Leb i sol=
Divlje jagode=
Smak=
Atomsko sklonište=
Kerber=

Kao i jučer
Satelit
Kontakt je skup
Zauvijek tvoj
Digni me visoko
Hajde da se volimo
Gradske cure
Olujni mornar

*SIMBOLI HEMIJSKIH ELEMENATA
HROM=
KSENON=
STRONCIJUM=
ANTIMON=
CIRKONIJUM=
CINK=
RADIJUM=
RADON=

Zr
Rn
Zn
Sb
Xe
Cr
Ra
Sr

*Reke i mora u koja se ulivaju
Krka=
Dnjepar=
Ind=
Gang=
Jenisej=
Lena=
Odra=
Var=

Laptevsko more
Ligursko more
crno more
jadransko more
Karsko more
Bengalski zaliv
Baltičko more
arabijsko more

*imena i dela (pesme, pripovetke, romani...)
Stevan Sremac=
Svetozar Marković=
Laza Lazarević=
Aleksa Šantić=
Jovan Dučić=
Petar Kočić=
Dušan Vasiljev=
Ivo Andrić=

Čovek peva posle rat
Jazavac pred sudom
Srbija na istoku
Ex ponto
Moja otadžbina
Na bunaru
Zalazak sunca
Vukadin

*Povežite književne likove sa delima
Haim=
Lotika=
Vuk Isakovič=
Hasan=
Aćim Katić=
Sofka=
Mane=
Ilija Jugović=

Zona Zamfirova
Nečista krv
Na Drini ćuprija
Nož
Derviš i smrt
Seobe
Koreni
Prokleta Avlija

*Spoji imena i prezimena Predsednika SSSR-a i Rusije :
Nikita=
Vladimir=
Jurij=
Leonid=
Boris=
Dmitrij=
Mihail=
Josif V.=

Staljin
Gorbačov
Jeljcin
Hruščov
Andropov
Putin
Brežnjev
Medvedev

*u kojim drzavama se nalaze sledeci gradovi
Liberec=
Donjeck=
Malme=
Krakov=
Kaunas=
Grac=
Kranj=
Bilefeld=

Poljska
Slovenija
Litvanija
Ukrajina
Češka
Švedska
Nemačka
Austrija

*Rodbinske veze
Deda=
Zaova=
Pašenog=
Stric=
Tašta=
Svastika=
Jetrva=
Dever=

Deverova žena
Ženina sestra
Svastikin muž
Muževa sestra
Mužev brat
Ženina majka
Očev brat
Očev otac

*Stilske figure
Antiteza=
Onomatopeja=
Personifikacija=
Hiperbola=
Alegorija=
Gradacija=
Epitet=
Metafora=

Preuveličavanje
Ukrasni pridev
Slikovit način govora
Glasovi iz prirode
Suprotnost
Ljudske osobine stvarima
Skraćeno poređenje
Ređanje po jačini

*Izbrojte tačke
1=
2=
3=
4=
5=
6=
7=
8=

.....
........
......
....
..
.
.......
...

*SUV proizvođači i modeli
Ford=
Opel=
Volvo=
Citroen=
VW=
Chevrolet=
Hyndai=
Nisan=

Antara
Tucson
Captiva
C-Crosser
Tiguan
XC60
Murano
Kuga

*Grad sa najviše stanovnika 2010
Ekvador=
Maroko=
SAD=
Turska=
Pakistan=
Kanada=
Kina=
Novi Zeland=

Kazablanka
Šangaj
Montreal
Istanbul
Karači
Njujork
Oklend
Gvajakvil

*Filmovi i režiseri...
Malteški soko=
Građanin Kejn=
Džentlmenski sporazu=
Lorens od Arabije=
Pijanista=
Blistavi um=
Malena=
Pirati sa Kariba=

Đuzepe Tornatore
Ron Hauard
Elija Kazan
Orson Vels
Gor Verbinski
Roman Polanski
Dejvid Lin
Džon Hjuston

*Filmovi i reziseri...
Ben Hur=
Rebeka=
Kazablanka=
Prohujalo sa vihorom=
Odavde do vecnosti=
Jesenja sonata=
Most na reci Kvaj=
Razjareni bik=

Ingmar Bergman
Vilijam Vajler
Martin Skorceze
Fred Sineman
Alfred Hickok
Viktor Fleming
Dejvid Lin
Majkl Kertiz

*????? ? ????????? ???????
????=
??????=
??????=
??????????=
??????=
?????=
??????=
?????=

????????
?????????
?????
??????????
??????
?????????
??????????
??????

*????????? ? ??????? ?????? ?????
??????????=
?????=
??????????=
????????=
?????????=
?????????=
???????????=
???? ?????=

????????
???? ???
????????
?????????
????????
???????
????????
????? ?????????

*Nobelovci za književnost i njihovi romani
Henrik Sjenkjevič=
Sigrid Undset=
Knut Hamsun=
Mihail Šolohov=
Doris Lesing=
Anatol Frans=
Alber Kami=
Vilijam Golding=

Bogovi su žedni
Gospodar muva
Proleće
Quo vadis?
Peto dete
Tihi Don
Kuga
Plodovi zemlje

*Price
Hajduk Stanko=
Autobiografija=
Gradinar=
Verenici=
Plava Zvezda=
Orlovi rano Lete=
Bure=
       Tijo Noci=

J.J.Zmaj
Isidora Sekulic
Mika Antic
Janko Veselinovic
Rabindranat Tagore
Branislav Nusic
Danilo Kis
Branko Copic

*Kojim sportom se bave sledeći sportisti
majkl felps=
bode miler=
miloš teodosić=
robert kranjec=
nikola karabatic=
mikko hirvonen=
sem kveri=
dejan stanković=

ski skokovi
kosarka
alpsko skijanje
rukomet
tenis
automobilizam
fudbal
plivanje

*Nacionalna pića
mastika=
sake=
tekila=
rum=
votka=
pivo=
džin=
šljivovica=

karibi
srbija
češka
engleska
grčka
japan
meksiko
rusija

*grupe i njihove pevačice
Pretenders=
Blondie=
No Doubt=
Texas=
Black Eyed Peas=
The Pussycat Dolls=
Fleetwood Mac=
Eurythmics=

Fergi
Eni Lenox
Nikol Šerzinger
Šarlin Spiteri
Debi Hari
Krisi Hajnd
Stivi Niks
Gven Stefani

*grupe i njihovi pevači
Nirvana=
Ultravox=
Human Lig=
Genesis=
INXS=
Simple Red=
Coldplay=
Duran Duran=

Mik Haknel
Kurt Kobejn
Sajmon Le Bon
Majkl Hačins
Midž Ur
Fil Kolins
Kris Martin
Fil Ouki

*???????? ??????? ????????????
???? ???????=
?????? ??????????=
???? ????=
???????? ???????=
????? ??????=
????? ???????=
?????? ??????????=
?????? ?????????=

???????
????????
?????????
?????.???????????
???????
????????
?????????
??????????????

*KNJIGE
MESA SELIMOVIC=
ARTUR KONAN DOJL=
CARS BUKOVSKI=
ONORE DE BALZAK=
SOFOKLE=
VUK DRASKOVIC=
MILOVAN GLISIC=
MIHAIL SOLOHOV=

NOZ
TIHI DON
BASKERVILSKI PAS
DERVIS I SMRT
ANTIGONA
CICA GORIO
GLAVA SECERA
BLUDNI SIN

*Zastave država i broj zvezda na njima
SAD=
Mikronezija=
Kina=
Venecuela=
Australija=
Barbados=
Kuba=
Sirija=

50
0
8
6
4
2
5
1

*Zimske olimpijske igre i godine odrzavanja
Lilehamer=
Kalgari=
Solt Lejk Siti=
Nagano=
Torino=
Sarajevo=
Vankuver=
Albervil=

2010
1984
1988
1992
1998
2002
2006
1994

*Hemijski elementi i njihovi simboli
Bakar=
Kalaj=
Cink=
Antimon=
Olovo=
Fosfor=
Živa=
Ajnštajnijum=

Pb
Es
P
Sb
Sn
Cu
Hg
Zn

*Heroji i njihovi neprijatelji
Talični Tom=
Supermen=
Betmen=
Vulverin=
Spajdermen=
Konan=
Šerlok Holms=
Luk Skajvoker=

Ratamon
Leks Lutor
Džoker
Doktor Morijarti
Braća Dalton
Dart Vejder
Magneto
Oktopus

*Godine života naučnika
Nikola Tesla=
Nikola Kopernik=
Albert Ajnštajn=
Isak Njutn=
Galileo Galilej=
Karl Fridrih Gaus=
Karl Line=
Čarls Darvin=

1856-1943
1777-1855
1643-1727
1564-1642
1473-1543
1809-1882
1879-1955
1707-1778

*pevaci i godine rodjenja
Željko Bebek=
Zdravko Čolić=
Darko Rundek=
Josipa Lisac=
Davorin Popović=
Rođa Raičević=
Cune Gojković=
Arsen Dedić=

1957.
1945.
1938.
1946.
1951.
1950.
1932.
1956.

*???????? ??????????? ????
????? ??????=
????? ??????=
????? ?????=
????? ?????????=
?????????? ?????=
????? ???????=
????? ??????=
?????? ??????=

?????????
??????? ???????????
????? ? ??????
????????? ?????????
???????
?????????
?????????
???????? ???????

*???? ??????? ???????
???? ??????=
???? ?????????=
???? ?????????=
????? ?? ?????=
??????  ??????=
???? ??????=
????? ???????=
??????? ????????=

??????? ? ??????
???? ????
?????? ?? ??????
?????? ????
????? ????
????  ??????
?????? ????
??????? ???????

*Spojite glumce sa filmovima u kojim su glumili:
Dustin Hofman=
Kirk Daglas=
Alen Delon=
Gererd Depardje=
Al Paćino=
Džan Reno=
Havier Bardem=
Brus Vilis=

More u nama
Veliko plavetnilo
Samuraj
Finalno odbrojavanje
12 majmuna
Serpiko
Zelena karta
Rainman

*Spojite uloge Al Paćina sa filmovima u kojim je glumio:
Doni Brasko=
Vrelina=
Lice sa ožiljkom=
88 minuta=
Serpiko=
Kum=
Pasje popodne=
Insomija=

dr Džek Grem
Soni Vorcik
Frenk Serpiko
Vinsent Hana
Bendžamin Ružiero
Toni Montano
Vil Dormer
Majkl Korleone

*?????????? ?????????????
?????=
?????????=
???????=
???????=
????=
?????????=
??????=
?????????????=

????????????
??????????
?????????? ????
?????? ?????
?????????? ????
??????????
????? ???????
????? ?????

*?????? ???? ????????
???????=
???????=
??????=
??????? ??????=
???? ????=
??? ????????=
????????=
????=

???? ?????
??????? ????????
???? ???????
???? ?????
???? ?????????
?????? ???????
???? ??????????
???? ????????

*Glavni gradovi Evrope na slovo B
Berlin=
Beč=
Bratislava=
Budimpešta=
Beograd=
Bukurešt=
Bern=
Brisel=

Mađarska
Švajcarska
Srbija
Austrija
Nemačka
Slovačka
Belgija
Rumunija

*??????? ?????????????? ???????
??????=
?????? ???????????=
???????? ???????=
?????????=
????  I=
????????=
???????=
?????=

??? ???????
????????
????????, ??????
????????
?????? ????????
??? ???? ????
??????
??????????, ???

*????? ??????? ??????? ???????
????? I ????????????=
?????????? ????????????=
?????????? ?????????=
????? ?????????=
??????? ?????????=
????? ?????????=
?????????=
?????? ??????=

??????
??????????
????????
??????
?????
??????
?????
??????

*Spojite glumce i njihove uloge u filmu Maratonci
Radislav Lazarević=
Mića Tomić=
Zoran Radmilović=
Fahro Konjhodžić=
Bata Stojković=
Bata Paskaljević=
Melita Bihalji=
Seka Sablić=

Maksimilijan
Olja,kućna pomoćnica
žandar
gosp. Rajković
Laki
Bili Piton
Kristina
Pantelija

*Evrovizija - pobednici 21. vek
Rusija=
Srbija=
Estonija=
Turska=
Letonija=
Danska=
Ukrajina=
Finska=

2003
2001
2007
2002
2004
2000
2006
2008

*Glavni gradovi evropskih regija
Pijemont=
Andaluzija=
Limburg=
Valonija=
Kampanija=
Tiringija=
Katalonija=
Sev.Rajna-Vestfalija=

Torino
Erfurt
Namir
Napulj
Sevilja
Diseldorf
Mastriht
Barselona

*Godine održavanja bitaka
Bitka na Čegru=
Bitka na Ivankovcu=
Bitka na Miša=
Bitka kod Velbužda=
Marička bitka=
Kosovska bitka=
Kolubarska bitka=
Bitka na Grahovcu=

1809.
1914.
1330.
1389.
1371.
1806.
1805.
1858.

*Povežite gradove i njihove brojeve stanovnika u užem područiju
Beograd=
Subotica=
Vranje=
Zrenjanin=
Kruševac=
Sombor=
Čačak=
Kragujevac=

51.471
1.119.642 
146.373
65.400
99.471
79.773
73.217 
55.742

*Spoj poznate vojskovođe sa državama iz kojih potiču
Omar Bredli=
Džingis Kan=
Bernard Montgomeri=
Ervin fon Vicleben=
Mihail Miloradovič=
Živojin Mišić=
Nikola Katina=
Vitorio Ambrozio=

Srbija
Italija
Mongolija
USA
Rusija
Nemačka
Francuska
V. Britanija

*Savremeni pisci i njihova dela
Grozdana Olujić=
Ljubomir Simović=
Žarko Komanin=
Slobodan Zubanović=
Petar Matović=
Slobodan Vladušić=
Živorad Nedeljković=
Ljiljana Đuretić=

Glasovi u vetru
Onaj svet
Koferi Džima Džarmuš
Ljetopis večnosti
Planeta Dunav
Svi na kraju kažu ma
Soneti sa sela
Forward

*Poveži imena i prezimena vajara
Đorđe=
Stevan=
Živorad=
Nikola=
Vuk=
Petar=
Milan=
Henri=

Jovanović
Ubavkić
Pešić
Bojović
Knežević
Mur
Maksimović
Stanisavljević

*poveži pobedničke pesme evrovizije sa njihovim izvođačima 
ABBA=
Toto Kutunjo=
Lordi=
Karlot Pereli=
Sertab Erener=
Marija Šerifović=
Žan Klod Paskal=
Riva=

Molitva
Rock me
Insieme
Vaterlo
Everyway That I Can
Take me to your heav
Nous Les Amoureux 
Hard Rock Hallelujah

*Istorijski pojmovi
Španska=
Papska=
Vajmarska=
Atlantska=
Marokanska=
Grčka=
Američka=
Jakobinska=

armada
vatra
povelja
kriza
država
diktatura
republika
revolucija

*Istorijski pojmovi
Solunski=
Afrički=
Španski=
Drugi=
Majski=
Jermenski=
Minhenski=
Jonski=

građanski rat
korpus
sporazum
ustanak
prevrat
genocid
svetski rat
proces

*Godine rođenja pisaca
J. J. Zmaj=
Davičo=
Tolstoj=
Šantić=
Ćopić=
Dostojevski=
Kiš=
Nušić=

1868
1864
1821
1935
1833
1909
1828
1915

*Slikari i njihova dela
Tajna večera=
Atinska škola=
Stvaranje Adama=
Noćna straža=
Kafana noću=
Planina san Viktoar=
Vrisak=
Violina=

Leonardo da Vinči
Edvard Munk
Rembrant
Pol Sezan
Van Gog
Mikelanđelo 
Rafaelo Santi
Pablo Pikaso

*Lekari specijalisti
oftalmolog=
akušer=
otorinolaringolog=
urolog=
endokrinolog=
dermatolog=
ortoped=
kardiolog=

oči
koža
mokraćni putevi
žlezde
trudnice
srce
uho-grlo-nos
kosti i zglobovi

*Spoji nazive pjesama sa njihovim izvođačima
Prokleta nedjelja=
Crna dama=
 Apokalipso=
 Bijele ruze=
Sve smo mogli mi=
Na jedan dan=
 E, moj doktore=
Mene tjera neki vrag=

Zana
Regina
Darko Rundek
Smak
Zeljko Bebek
Jadranka Stojakovic
Maja Blagdan
Parni Valjak

*Spoji sportove sa odgovarajućim sportistima
Lennox Lewis=
Dejan Bodiroga=
Jelena Isinbajeva=
 Inge d?  Brojn=
Martina Sablikova=
Igor Milanović=
Jasna Šekarić=
Bjern Borg=

vaterpolo
boks
tenis
brzo klizanje
košarka
plivanje
streljaštvo
skok s motkom

*Spoji nazive pjesama sa njihovim izvođačima
Don't wanna lose you=
Frozen=
 Come To Me=
 Maria Maria=
We Are The Champions=
La Passion=
Daddy Cool=
I Have Nothing=

MADONNA
Boney M
Gigi
Santana
Queen
Ricky Martin
Whitney Houston
Tina Tarner

*Za koju državu su igrali fudbaleri?
Pele=
Erik Kantona=
Euzebio=
Gerd Miler=
Dragan Džajić=
Đordž Vea=
Bobi Čarlton=
Paulo Maldini=

Brazil
Engleska
Nemačka
Liberija
Jugoslavija
Portugal
Francuska
Italija

*Spoji pisce sa djelima koja su napisali
Koštana=
Lovčevi zapisi=
Zapisi iz podzemlja=
Antigona=
Čarobni breg=
Evgenije Onjegin=
Gdje priče rastu=
Orlovi rano lete=

Ivan.S.Turgenjev
Grigor Vitez
A.S.Puškin  
Sofokle
Thomas Mann
Fjodor M.Dostojevski
Branko Ćopić
Bora Stanković

*spoji pisce i njihova dela
herman hese=
sidni seldon=
paulo koeljo=
august senoa=
agata kristi=
emil zola=
gogolj=
frank herbert=

seljačka buna
alhemicar
zavera sudnji dan
tajna zamka cimniz
revizor
nana
dina
narcis i zlatousti

*politicke partije i lideri
SPO=
DS=
DSS=
G17=
SPS=
LDP=
SNS=
SRS=

Cedomir Jovanovic
Vojislav Seselj
Boris Tadic
Vuk Draskovic
Ivica Dacic
Mladjan Dinkic
Tomislav Nikolic
Vojislav Kostunica

*povezati slikare sa njihovim delima
???? ????=
??????????=
????????? ?? ???????=
?????? ????=
?????=
???????? ????=
???? ?????=
??????????=

???? ?????????
?????? ????????
???? ?????????
??????? ??? ???
????????? ????
????? ??????
???? ?????
??? ?????

*Povezati pisce sa delima
Onore de Balzak=
Šarl Bodler=
Émile Zola=
Dositej Obradović=
Antun Gustav Matoš=
Žak Prever=
Stevan Sremac=
Aleksandar Puškin=

Ljiljan u dolu
&quot;Ibiš-aga
Oko Lobora
U ključalom loncu 
Cveće zla
Braća razbojnici
Ljubezni Haralampije
Sunce noći

*Spoji vrhove sa planinama na kojima se nalaze
Veliki Šturac=
Stolice=
Tornik=
Zimomor=
Rudoka=
Đeravica=
Veliki Zavižan=
 Sveti Jure=

Crvanj
Zlatibor
Majevica
Šar-planina
Velebit
Prokletije
Biokovo
Rudnik

*Pozivni brojevi za države
+34=
+7=
+44=
+32=
+46=
+359=
+39=
+420=

Češka
Italija
Švedska
Španija
Engleska
Rusija
Belgija
Bugarska

*Pozivni brojevi za države
Slovenija=
Nemačka=
Austrija=
Francuska=
Danska=
Holandija=
Srbija=
Grčka=

+33
+386
+45
+31
+30
+43
+381
+49

*Spojite saobraćajna preduzeća sa gradovima
VALJEVO=
VRŠAC=
SOMBOR=
POŽAREVAC=
UŽICE=
NIŠ=
BEOGRAD=
ŠABAC=

STRELA
LASTA
LITAS
EKSPRES
RAKETA
SEVERTRANS
STUP
7.JULI

*Premijeri država 2009
Hrvatska=
Slovačka=
Holandija=
Švedska=
Slovenija=
Češka=
Poljska=
Belgija=

Jadranka Kosor
Donald Tusk
Borut Pahor
Jan Peter Balkenende
Robert Fico
Iv Leterm
Fredrik Rajnfelt
Jan Fišer

*Filmovi i godine objavljivanja
Moja Afrika=
Apartman=
Ples s vukovima=
Lovac na jelene=
Francuska veza=
Vatrne kočije=
Ponoćni kauboj=
Kišni čovek=

1978
1969
1971
1960
1985
1990
1988
1981

*Velimir Bata Živojnović
Valter brani SA=
Bolji život=
Žikina dinastija=
Ćao inspektore=
Srećni ljudi=
Bure baruta=
Priče iz radionice=
Čudo neviđeno=

Otac Makarije
Pufta
Aranđel Golubović
Valter
dr Nedeljković
Macola
Boki
Vozač autobusa

*Glavni gradovi država Južne Amerike
Paragvaj=
Venecuela=
Čile=
Bolivija=
Kolumbija=
Ekvador=
Peru=
Urugvaj=

Kito
Asunsion
Montevideo
Bogota
Karakas
Sukre
Lima
Santjago

*Košarkaški klubovi i gradovi
Caha Laboral=
Montepaski=
Prokom=
Žalgiris=
Huventud=
Armani Džins=
Unkiaha=
Alba=

MIlano
Vitorija
Berlin
Badalona
Sijena
Kaunas
Malaga
Gdinja

*Uloge Vlastimira Đuze Stoiljkovića
Bela lađa=
Stižu dolari=
Srećni ljudi=
Otvorena  vrata=
U ime zakona=
Pozorište u kući=
VIše od igre=
Diplomci=

Rodoljub Petrović
Gavrilo Petričević
Dimitrije Crnjavčević
Radoje Stanojević
Aleksandar Ljutić
Antonije Micić
Apotekar Beli
Marinko

*Atletičari i discipline
Dragan Životić=
Vladimir Milić=
Borislav Pisić=
Frano Mihalić=
Dane Korica=
Nenad Stekić=
Miloš Srejović=
Rok Kopitar=

maraton
110m, prepone
bacač kugle
5000  i 10000 m
troskok
skok u dalj
400m, prepone
800m

*Aktuelni muški olimpijski pobednici (2009)
fudbal=
stoni tenis dubl=
vaterpolo=
rukomet=
hokej na travi=
bejzbol=
tenis dubl=
odbojka=

Kina
Švajcarska
Južna Koreja
Francuska
Nemačka
Mađarska
SAD
Argentina

*sportisti i sportske discipline
Frano Mihalić=
Branko Zebec=
Ljubodrag Simonović=
Leon Štukelj=
Petrit Fejzula=
Matija Ljubek=
Fazlija Šaćirović=
Ljubomir Travica=

atletika
kajak
gimnastika
rukomet
fudbal
odbojka
košarka
boks

*Spojite marke vozila sa modelima
Opel=
Ford=
BMW=
Fiat=
Zastava=
Ševrolet=
Folksvagen=
Audi=

Camaro
TT
Mustang
Insignia
10
Bravo
T4
537

*grupe i njihove pesme
sunshine=
orthodox celts=
goblini=
direktori=
bijelo dugme=
riblja corba=
azra=
haustor=

ide voz
mito bekrijo
ima neka tajna veza
drinking song
iza horizonta
anja volim te
ena
rekla je

*sportistkinje i sportske discipline
Vera Jeftimijades=
Svetlana Kitić=
Đurđa Bjedov=
Vera Nikolić=
Mateja Svet=
Anđelija Arbutina=
Mima Jaušovec=
Milena Reljin=

tenis
košarka
rukomet
ritmička gimnastika
atletika
plivanje
skijanje
mačevanje

*HEMIJSKI ELEMENTI I SIMBOLI
Kadmijum=
Ajnštajnijum=
Stroncijum=
Tulijum=
Cerijum=
Talijum=
Rodijum=
Živa=

Sr
Es
Rh
Hg
Ce
Tl
Tm
Cd

*Nikola Đuričko
Vratiće se rode=
Otvorena vrata=
Sedam i po=
Pljačka trećeg rajha=
Munje=
Kad porastem biću...=
Bumerang=
Zona Zamfirova=

Kalauz
Švaba
Gojko Sisa
Kengur
Perica
Simke
Stampedo
Vojkan Jakovljević

*Olimpijske prvakinje 2008.
trčanje 100 m=
badminton singl=
streljaštvo puška10m=
stoni tenis singl=
pliv. 100m slobodno=
skok s motkom=
džudo ekstralaka=
tenis singl=

Šeli-En Frejzer
Alina Dumitru
Brita Štefen
Katerina Emons
Žang Ning
Elena Dementijeva
Žang Jining
Jelena Isinbajeva

*Uloge Dragana Bjelogrlića
Bolji život=
Boško Buha=
Pozorište u kući=
Vratiće se rode=
Mješoviti brak =
Lepa sela lepo gore=
Nebeska udica=
Ivkova slava=

Ekser
Toza
Backović
Savo Jovanović
Slobodan Popadić
Rodoljub Petrović
Kalča
Milan

*Olimpijski prvaci 2008.
maraton=
100 metara trčanje=
džudo polulaka=
dizanje tegova+105kg=
tenis singl=
stoni tenis singl=
100 metara leptir=
mauntin bajk=

Ma Lin
Samjuel Vandžiru
Žilijen Absalon
Rafael Nadal
Jusein Bolt
Matijas Štajner
Majkl Felps
Masato Učišiba

*Uloge Dragoslava Dragana Nikolića
Ranjeni Orao=
Sva ta ravnica=
Porodično blago=
Bolji život=
Vratiće se rode=
Drug crni u NOB-u=
Pozorište u kući=
M(j)ešoviti brak=

Mutavi
Rale
Bob
Đorđe Pašalić
MIlan Jagodić
Uglješa Knežević
BratislavNikolajević
Labud Stojanović

*navijači klubova
partizan=
crvena zvezda=
vojvodina=
zemun=
rad=
ofk beograd=
radnički niš=
radnicki kragujevac=

blue union
crveni đavoli
delije
grobari
united force
taurunum boys
meraklije
firma

*Predrag Miki Manojlović
Bure Baruta=
Rane=
Podzemlje=
Otac na služb. putu=
Grlom u jagode=
Mi nismo anđeli=
Klopka=
Tito i ja=

Zoranov otac
Kosta Antić
Miki Rubiroza
Mane
Marko Dren
Stojan
Mehmed Mesa Zolj
Milan

*DOBITNICI NIN-OVE NAGRADE I NJIHOVI ROMANI
OSKAR DAVIČO=
MIROSLAV KRLEŽA=
MIHAILO LALIĆ=
ALEKSANDAR TIŠMA=
ŽIVOJIN PAVLOVIĆ=
DAVID ALBAHARI=
MLADEN MARKOV=
GROZDANA OLUJIĆ=

ZID SMRTI
GLASOVI U VETRU
MAMAC
UPOTREBA ČOVEKA
ZASTAVE
BETON I SVICI
UKOP OCA
RATNA SREĆA

*Najbolji strelci svetskih prvenstava u fudbalu
Ronaldo=
Gari Lineker=
Paolo Rosi=
Žist Fonten=
Gerd Miler=
Salvatore Skilaći=
Mario Kempes=
Davor Šuker=

1978.
1990.
1982.
1986.
1998.
1970.
1958.
2002.

*Istorijski protivnici
Napoleon=
Hitler=
Cezar=
Darije=
Samsonov=
Gaj Marije=
Staljin=
Robert Li=

Kornelije Sula
Velington
Ulis Grant
Hindenburg
Čerčil
Aleksandar Veliki
Trocki
Pompej

*Najbolji strelci evropskih prvenstava u fudbalu
Diter Miler=
Savo Milošević=
Milan Baroš=
Dragan Džajić=
MIšel Platini=
Alan Širer=
David Vilja=
Marko van Basten=

1968.
2004.
2000.
1984.
2008.
1996.
1988.
1976.

*povezi pronalazace i njihove izume
Samuel Colt=
Corradino D'Ascanio=
Leonardo da Vinci=
Douglas Engelbart=
Enrico Fermi=
Alexander Fleming=
Karl von Dreis=
Samuel Morse=

revolver
bicikl
nuklearni reaktor
padobran
vespa
telegraf
racunarski mis
penicilin

*Uloge Nikole Simića
Kafanica za SIS=
Stižu dolari=
Porodično blago=
Srećni ljudi=
Tesna koža=
Crni Gruja=
Drugarica ministarka=
Vuk Karadžić=

Spiridon Karamarković
Spasoje
Dimitrije Pantić
Tripko  Stojković
Aleksandar Ljutić
Dr Jozef Škoda
Mihajlo Ostojić
Slavko Mitezer

*Uloge Velimira Bate Živojinovića
Srećni ljudi=
Seljaci=
Porodično blago=
Bolji život=
Drugi crni u NOB-u=
Ivkova slava=
Nož=
Lepa sela lepo gore=

Gvozden
Nićifor Jugović
Valter
Aranđel Golubović
Majstor Kreka
Jeremija
Aleksandar Kostić 
Gospodin Mirko

*Uloge Dragana Jovanovića
Stižu dolari=
Bela lađa=
Srećni ljudi=
Moj rođak sa sela=
Porodično blago=
Otvorena vrata=
Lajanje na zvezde=
Stršljen=

Predrag Peša Ljutić
Gradimir Stević
Dragorad Malešević
Žuća
Dragiša Svilarević
Milun Lune Šćekić
Dr Dušan Maričić
Boban Đorđević

*Svetski prvaci u atletici u 2009. godini i njihove discipline
100m=
10.000m=
Skok u vis=
Skok s motkom=
Skok u dalj=
Bacanje koplja=
400m=
800m=

Mbulaeni Mulaudzi
LaShawn Merritt
Dwight Phillips
Usain Bolt
Yaroslav Rybakov
Kenenisa Bekele
Steven Hooker
Andreas Thorkildsen

*Prezimena i imena vozača Formule 1
Baton=
Fetel=
Veber=
Kubica=
Hajdfeld=
Rozberg=
Hamilton=
Glok=

Robert
Timo
Niko
Luis
Dženson
Sebastijan
Mark
Nik

*Sportistkinje i sportovi
Federika Pelegrini=
Lidija Mihajlović=
Karolina Kostner=
Tanja Putiainen=
Nastia Liukin=
Tamara Boroš=
Nataša Janjić=
Elena Dementijeva=

Stoni tenis
Plivanje
Tenis
Gimnastika
Streljaštvo
Alpsko skijanje
Kajak
Umetničko klizanje

*Reči na francuskom i srpskom
sestra=
slova=
ptica=
komšinica=
oblak=
svetlo=
prst=
haljina=

les lettres
le doigt
la lumiere
la voisine
le nuage
un oiseau
la robe
la soeur

*Bajke
Snežana=
Crvenkapa=
Ivica i Marica=
Tri praseta=
Mačak u čizmama=
Hrabri krojač=
Pepeljuga=
Zlatokosa=

Kuća od čokolade
Vuk pojeo baku
Staklena papučica
Tri medveda
Čarobnjak pretvoren u miša
7 muva jednim udarcem
Vuk oduvao kuću
Otrovna jabuka

*Matematika
1-1=
2+2=
3?=
?4=
5!=
6·6=
|7|=
8/8=

36
1
4
0
120
2
7
27

*Ličnost i reka
Karlo Veliki=
Tito=
Cezar=
Eugen Savojski=
Oskar Poćorek=
Aleksandar Veliki=
Živojin Mišić=
Fridrih Paulus=

Volga
Kolubara
Drina
Ebro
Rubikon
Neretva
Tisa
Granik

*Evropski prvaci u fudbalu
1968.=
2004.=
1964.=
1976.=
2000.=
1960.=
1988.=
1992.=

SSSR(Rusija)
Danska
Grčka
Italija
Francuska
Čehoslovačka(Češka)
Holandija
Španija

*Gradovi na D i države
Debrecin=
Derbi=
Debar=
Dejang=
Denizli=
Delemont=
Devnia=
Debica=

Poljska
Bugarska
Turska
Mađarska
Makedonija
Engleska
Kina
Švajcarska

*Povežite pesme sa muzičkim grupama:
Satelit=
Lažeš=
Nemoj srećo=
Šejn=
Kumova slama=
Seobe=
Ima nade=
Rođen loš=

Leb i sol
Partibrejkers
Kerber
Haustor
Bijelo dugme
Smak
Yu grupa
Riblja čorba

*Koje godine su osvojile Wimbledon ?
serena vilijams=
venus vilijams=
ameli moresmo=
martina hingis=
štefi graf=
marija šarapova=
lindzi devenport=
jana novotna=

1999
2004
2006
2008
1998
1996
1997
2009

*Najbolji strelci Svetskih prvenstava u fudbalu
SP 1954=
SP 1966=
SP 1970=
SP 1978=
SP 1982=
SP 1986=
SP 1990=
SP 1998=

Mario Kempes 
Šandor Kočiš
Paolo Rosi
Geri Lineker
Davor Šuker
Gerd Miler
Salvatore Skilači 
Euzebio 

*EX-YU Pop
Galija=
Garavi Sokak=
Balašević=
Miki Jevremović=
Posled. igra leptira=
Regina=
Zlatko Pejaković=
Leb i sol=

Ove noći 1 žena
Ljubav nije za nas
Nevernik
Ruzmarin
Čuvam noć od budnih
Srce od meda
Ako 1 vidiš Mariju
Na tvojim usnama

*Imena i prezimena plivača i plivačica
Nađa=
MIlorad=
Ivan=
Čaba=
Vladan=
Radovan=
Miroslava=
Marica=

Čavić
Najdanovski
Siljevski
Silađi
Marković
Lenđer
Stražmešter
Higl

*Košarkaski klubovi i gradovi
Partizan=
Lottomatica=
Panathinaicos=
Armani Jeans=
Pamesa=
Cibona=
Union Olimpija=
Efes Pilsen=

Ljubljana
Zagreb
Rim
Istanbul
Milano
Atina
Valensija
Beograd

*koje godine su osvojili wimbledon ?
roger federer=
rafael nadal=
lejton hjuit=
goran ivanišević=
pit sampras=
ričard krajček=
andre agasi=
mihael štih=

2008
1992
1996
2001
2000
2002
1991
2009

*Drzave i glavni gradovi
Španija=
Grčka=
Island=
Mađarska=
Cad=
Japan=
Kazahstan=
Gruzija=

Tokio
Atina
Rejkjavik
Astana
Madrid
Tbilsi
Budimpešta
Ndzamena

*režiser - filmovi
avatar=
kad jaganjci utihnu=
amadeus=
kum=
forest gamp=
E.T.=
razjareni bik=
dobar, loš, zao=

james cameron
martin scorsese
robert zemeckis
milos forman
johnatan demme
sergio leone
francis f. coppola
steven spielberg

*Višestruki olimpijski prvaci
Majkl Felps=
Li Ning=
Pavo Nurmi=
Bredli Vigins=
Teofilo Stivenson=
Ralf Šuman=
Vang Nan=
Andrej Lavrov=

streljaštvo
plivanje
rukomet
boks
gimnastika
biciklizam
stoni tenis
atletika

*Kojim sportom se bave ?
Jakov Fak=
Lukas Bauer=
Magnus Moan=
Aksel Lund Svindal=
Simon Aman=
Magnos Karlsen=
Sven Kramer=
Jevgenij Plusenko=

šah
umetničko klizanje
skijaško trčanje
biatlon
ski skokovi
alpsko skijanje
brzo klizanje
nordijska kombinacija

*Prestonice
Švajcarska=
Danska=
Švedska=
Norveška=
Finska=
Irska=
Island=
Slovačka=

Helsinki
Bratislava
Dablin
Oslo
Kopenhagen
Bern
Rejkjavik
Stokholm

*Fudbaleri i reprezentacije
Leo Mesi=
Nemanja Vidić=
Kristijano Ronaldo=
Fernando Tores=
Kaka=
Frank Riberi=
Stiven Džerard=
Đorđo Kijelini=

Argentina
Francuska
Španija
Brazil
Srbija
Italija
Portugal
Engleska

*Šahisti
Petrosjan=
Korcnoj=
Karpov=
Gligorić=
Fišer=
Talj=
Kasparov=
Lajoš=

Svetozar
Gari
Robert
Viktor
Tigran
Anatolij
Portis
Mihail

*Povežite likove iz domaćih filmova sa glumcima koji ih tumače:
Đura Čvorović=
Crni=
Flojd=
Ilija Čvorović=
Braca=
Bole=
Gojko=
Kaja=

Nikola Đuričko
Boris Milivojević
Lazar Ristovski
Nebojša Glogovac
Danilo Stojković
Dragan Nikolić
Sergej Trifunović
Zvonko Lepetić

*EX-YU balade
Parni valjak=
Merlin=
Balašević=
Kemal Monteno=
Leo Martin=
Mišo Kovač=
Crvena Jabuka=
Film=

Moja je pesma lagana
Volio bih da si tu
Volim te
Ne volim januar
Lažu me
Doći ću ti u snovima
Napiši 1 ljubavnu
Ostala si uvjek ista

*Povežite ime i prezime ovih poznatih muzičara:
Radomir=
Goran=
Vlatko=
Bora=
Laza=
Milan=
Davorin=
Dragi=

Bregović
Popović
Mladenović
Đorđević
Ristovski
Stefanovski
Jelić
Mihajlović

*Ličnost  i istorijski pojam
Musolini=
Robespjer=
Martin Luter=
Hernan Kortes=
Oliver Kromvel=
Ignjacije Lojola=
Deni Didro=
Garibaldi=

jezuiti
crvenokošuljaši
montanjari
crnokošuljaši
puritanci
konkistadori
enciklopedisti
evangelisti

*Povežite sportiste sa sportovima kojima se bave:
Fernando Alonso=
Sergej Tetjuhin=
Ivan Perez=
Žilbert Arenas=
Salomon Kalu=
Bertran Žil=
Endi Marej=
Majkl Felps=

Tenis
Rukomet
Odbojka
Plivanje
Košarka
Vaterpolo
Fudbal
Formula 1

*Filozofi
Erih=
Tomas=
Torkvato=
Dejvid=
Seren=
Artur=
Diogen=
Fridrih=

From
Apolonjanin
Hjum
Šopenhauer
Kjerkegor
Taso
Hobs
Niče

*Zapaljenja
Encefalitis=
Meningitis=
Gastritis=
Hepatitis=
Pankreatitis=
Miokarditis=
Mastitis=
Pneumonija=

moždane ovojnice
dojka
srčani mišić
jetra
gušterača
želudac
pluća
mozak

*Fudbalske reprezantacije i njihovi treneri (2009)
Srbija=
Brazil=
Argentina=
Hrvatska=
Rusija=
Engleska=
Španija=
Portugal=

Slaven Bilić
Maradona
Karlos Dunga
Gus Hidink
Del Boske
Fabio Kapelo
Karlos Keiroš
Radomir Antić

*Imena i prezimena nobelovaca
Orhan=
Semjuel=
Pablo=
Doris=
Vilijam=
Knut=
Gabrijela=
Henrik=

Neruda
Beket
Mistral
Sjenkevič
Golding
Hamsun
Lesing
Pamuk

*EX-YU Rok
Riblja Čorba=
Kerber=
Haustor=
Azra=
EKV=
Osvajači=
Parni valjak=
Zabranjeno pušenje=

Lutka za bal
Pronađi me
Uzalud pitaš
Hajde da se volimo
Zenica bluz
Ti si sav moj bol
A šta da radim
Jedino moje

*EX-YU Pop
Zdravko Čolić=
Đorđe Balašević=
Kemal Monteno=
Merlin=
Oliver Dragojević=
Miladin Šobić=
Arsen Dedić=
Bajaga=

Lažu me
Djevojka za 1 dan
Nedostaješ mi ti
Olelole
Produži dalje
Dušo Moja
Tišina
Od druga do druga

*Nazivi dela
Travnička=
Dnevnik=
Lovac na=
Čiča=
Ujka=
Hazarski=
Blago=
Lutajući=

hronika
rečnik
Gorio
Vanja
o Čarnojeviću
Bokelj
zmajeve
cara Radovana

*Opština i okrug
Kovačica=
Surdulica=
Babušnica=
Koceljeva=
Mali Iđoš=
Lučani=
Gadžin Han=
Štimlje=

Severnobački
Kosovski
Moravički
Mačvanski
Pčinjski
Južnobanatski
Nišavski
Pirotski

*Ex Yu hitovi i žene
Magazin=
Novi Fosili=
Srebrna Krila=
Alisa=
Bolero=
Kerber=
Haustor=
Prljavo Kazaliste=

Ena
Svetlana
Milena
Marina
Sanja
Ana
Dajana
Tamara

*Opština i okrug
Kula=
Bojnik=
Malo Crniće=
Pećinci=
Tutin=
Lajkovac=
Brus=
Rekovac=

Jablanički
Rasinski
Kolubarski
Sremski
Raški
Braničevski
Pomoravski
Zapadnobački

*Dobitnici Nobelovih nagrada za književnost i zemlje porekla 
Radjard Kipling=
Moris Meterlink=
Henrik Pontopidan=
Gabrijela Mistral=
Patrik Vajt=
Nadin Gordimer=
Samjuel Beket=
Džon Stajnbek=

Irska
Južnoafrička rep.
Belgija
SAD
Čile
Danska
Australija
Engleska

*Događaj i vek
Vartolomejska noć=
Kristalna noć=
Prvi krstaški rat=
Bečki kongres=
Milanski edikt=
Francuska revolucija=
Veliki bečki rat=
Verdenski sporazum=

9.
17.
4.
16.
11.
20.
19.
18.

*Grad na reci
Zrenjanin=Begej
Užice=Đetinja
Kruševac=Rasina
Lebane=Jablanica
Bijelo Polje=Lim
Banja Luka=Vrbas
Vučitrn=Sitnica
Svilajnac=Resava

*Reka se uliva u reku
Tisa=Dunav
Kolubara=Sava
Resava=Velika Morava
Lim=Drina
Ibar=Zapadna Morava
Studenica=Ibar
Jablanica=Južna Morava
Tamnava=Kolubara

*Sinonimi
Šija=Vrat
Vreća=Džak
Trbuh=Stomak
Lek=Medikament
Stupa=Avan
Aždaja=Ala
Ekser=Klin
Konac=Nit

*Mesto i region
Irig=
Đakovica=
Negotin=
Odžaci=
Bogatić=
Podujevo=
Opovo=
Kostolac=

Srem
Banat
Bačka
Kosovo
Mačva
Timočka Krajina
Metohija
Braničevo

*Autori i dela
Ivo Andrić=Gospođica
Meša Selimović=Derviš i smrt
Laza Lazarević=Vetar
Danilo Kiš=Enciklopedija mrtvih
Jovan St. Popović=Kir Janja
Milovan Glišić=Glava šećera
Branko Ćopić=Bašta sljezove boje
Radoje Domanović=Glava šećera


*Ime i prezime naših pesnika
Jovan=Dučić
Milan=Rakić
Momčilo=Nastasijević
Sima=Pandurović
Vasko=Popa
Miodrag=Pavlović
Stevan=Raičković
Laza=Kostić

*Istorijske ličnosti i vek smrti
M. Robespjer=
J. Gutenberg=
K. Kavur=
Fridrih Barbarosa=
Vudro Vilson=
Francisko Pizaro=
Oliver Kromvel=
Dušan Silni=

14.
17.
20.
18.
19.
15.
12.
16.

*Anagrami reka
Treska=kraste
Moskva=smokva
Struma=mustra
Kolima=lakomi
Korana=anorak
Garona=organa
Vardar=drvara
Dnjepar=prednja

*Vojskovođe i bitke
Cezar=Alezija
Aleksandar Veliki=Granik
Napoleon=Borodin
Temistokle=Salamina
Leonida=Termopili
Horacio Nelson=Trafalgar
Oktavijan=Akcij
Atila Hunski=Katalaunska polja

*Balaševićeve pesme
Stari laloški=vals
Ne volim=januar
Marim=ja
Čivutski=vrt
Divlji=badem
Odlazi=cirkus
Panonski=mornar
Stari=orkestar

*Strip junaci
Kapetan=Miki
Teks=Viler
Komandant=Mark
Blek=Stena
Marti=Misterija
Dilan=Dog
Kit=Teler
Mister=No

*Kompozitori
Hektor=Berlioz
Alban=Berg
Bela=Bartok
Bendžamin=Britn
Leopold=Mocart
Jan=Sibelijus
Antonio=Vivaldi
Domeniko=Skarlati

*Dnevne novine
Politika=Srbija
Pobjeda=Crna Gora
Vjesnik=Hrvatska
La Republika=Italija
Dejli telegraf=Velika Britanija
Dejli njuz=SAD
Oslobođenje=Bosna i Hercegovina
Der Tagesšpigel=Nemačka

*Anagrami glavnih gradova
Astana=satana
Manila=amalin
Niamej=manije
Kajena=nejaka
Erevan=nevera
Skoplje=pljoske
Moskva=smokva
Dablin=blinda

*Strani pisci i dela
Emili Bronte=Orkanski visovi
Henri Džejms=Portret jedne ledi
Artur Konan Dojl=Baskervilski pas
Vladimir Nabokov=Lolita
Džordž Orvel=Životinjska farma
Margaret Mičel=Prohujalo sa vihorom
Džek London=Beli očnjak
Alber Kami=Stranac

*Naši književnici i dela :
P. P. Njegoš=Luča mikrokozma
Petar Kočić=Jazavac pred sudom
Meša Selimović=Derviš i smrt
Branko Ćopić=Orlovi rano lete
Ranko Marinković=Ruke
Miloš Crnjanski=Roman o Londonu
Dragoslav Mihailović=Petrijin venac
Vuk Drašković=Meta

*Horoskopski znaci
Jarac=decembar-januar
Škorpija=oktobar-novembar
Lav=jul-avgust
Blizanci=maj-jun
Bik=april-maj
Vaga=septembar-oktobar
Ribe=februar-mart
Devica=avgust-septembar

*Evropske reke i mora u koja se ulivaju
Elba=Severno more
Odra=Baltičko more
Po=Jadransko more
Marica=Egejsko more
Dnjepar=Crno more
Don=Azovsko more
Ebro=Sredozemno more
Tibar=Tirensko more

*Države i mora na koja izlaze
Australija=Koralno more
Burma=Andamansko more
Italija=Ligursko more
Norveška=Severno more
Poljska=Baltičko more
Sudan=Crveno more
Turska=Mramorno more
Ukrajina=Azovsko more

*Sateliti i planete
Ganimed=Jupiter
Titan=Saturn
Mesec=Zemlja
Fobos=Mars
Oberon=Uran
Triton=Neptun
Haron=Pluton
Diznomija=Erida

*Vozači Formule 1 u sezoni 2009
BMW=
Toyota=
Red Bull=
STR-Ferrari=
Brawn GP=
Force India=
Renault=
Williams=

Adrian Sutil
Timo Glock
Sebastian Vettel
Romain Grosjean
Robert Kubica
Nico Rosberg
Sebastian Buemi
Jenson Button

*Gradovi Evrope
Vladikavkaz=Rusija
Gdanjsk=Poljska
Minsk=Belorusija
Taljin=Estonija
Riga=Letonija
Dnjepropetrovsk=Ukrajina
Liberec=Češka
Kaunas=Litvanija

*Ex Yu legende fudbala
Dejan=
Dragan=
Slobodan=
Stjepan=
Fahrudin=
Srećko=
Ilija=
Darko=

Savićević
Petković
Bobek
Katanec
Omerović
Santrač
Stojković
Pančev

*Predsednici država 2010.
SAD=
Rusija=
Kina=
Severna Koreja=
Južna Koreja=
Crna Gora=
Kuba=
Srbija=

Boris Tadić
Raul Kastro
Li Mjung Bak
Barak Obama
Hu Jintao
Dimitrij Medvedev
Kim Jong-il
Filip Vujanović

*Svetski poznati diktatori
Hugo=
Josif=
Fidel=
Muhamer=
Hu=
Kim=
Nikolaj=
Robert=

Al Gadafi
Čaušesku
Jintao
Staljin
Čavez
Kastro
Mugabe
Jong-il

*Režiseri - filmovi
Kristofer Nolan=
Braća Koen=
Ron Hauard=
Ridli Skot=
Džejms Kameron=
Klint Istvud=
Tim Barton=
Džim Džarmuš=

Ed Vud
Mistična reka
Apolo 13
Veliki Lebovski
Mrtav čovek
Istinite laži
Pad crnog jastreba
Prestiž

*Auto oznake država
A=
AUS=
GR=
D=
GE=
IRL=
IR=
I=

Nemačka
Grčka
Australija
Gruzija
Iran
Irska
Italija
Austrija

*Turističke destinacije
Budva=
Dubrovnik=
San Trope=
Rimini=
Kankun=
Antalija=
Hurgada=
Malaga=

Turska
Hrvatska
Francuska
Egipat
Crna Gora
Španija
Italija
Meksiko

*Valute skraćenice
ARS=
CHF=
SEK=
SGD=
AUD=
JPY=
USD=
GBP=

argentinski pezos
američki dolar
australijski dolar
švedska kruna
švajcarski franak
britanska funta
singapurski dolar
japanski jen

*Najpoznatiji slikari
Vinsent=
Salvador=
Pjer Avgustin=
Pablo=
Klod=
Džekson=
Viljem=
Gustav=

Van Gog
Polok
Pikaso
Mone
Dali
Klimt
Renoar
De Koning

*Poznate glumice
Merlin=
Ketrin=
Kameron=
Mišel=
Melani=
Džulija=
Greta=
Meril=

Roberts
Zeta Džouns
Diaz
Garbo
Monro
Strip
Fajfer
Grifit

*Najveće svetske znamenitosti
Grand kanjon=
Ajfelov toranj=
Tadž Mahal=
Maču Pikču=
Piramide=
Zid plača=
Koloseum=
Viktorijini vodopadi=

Izrael
SAD
Zimbabve
Egipat
Francuska
Peru
Italija
Indija

*Pisci i dela
Bora Stanković=
Ivo Andrić=
Stevan Sremac=
Danilo Kiš=
Čehov=
Jovan Popović=
Branislav Nušić=
Branko Ćopić=

Rani Jadi
Gazda-Mladen
Ujka Vanja
Tvrdica
Orlovi rano lete
Zona Zamfirova
Narodni poslanik
Priča o kmetu Simanu

*Manastiri Srbije
Temska=
Mileševa=
Ravanica=
Tronoša=
Prohor Pčinjski=
Rakovica=
Manasija=
Žiča=

Beograd
Pirot
Kraljevo
Vranje
Prijepolje
Loznica
Despotovac
Ćuprija

*merne jedinice 
sila=
elektricni napon=
kolicina elektricite=
snaga=
magnetna indukcija=
induktivnost=
elektricni otpor=
elektricni kapacitet=

njutn
om
tesla
kulon
volt
farad
vat
henri

*spojite licnosti i dela Branislava Nusica
Put oko sveta=
Gospođa ministarka=
Narodni poslanik=
Mister Dolar=
Ožalošćena porodica=
Pokojnik=
Sumnjivo lice=
Dr=

Jovanča Micic
Pavle Marić
gospođa Model Patu
Agaton Arsić
Sima Popović
Života Cvijović
Jevrem Prokić
Jerotije Pantić

*Serije
Crni=
Kuku=
Na=
Balkan=
Sva ta=
Ljubav i=
Mješoviti=
Vuk=

Vasa
Brak
Mržnja
Ekspres
Ravnica
Terapiji
Karadžić
Gruja

*Fudbalske legende
Mišel Platini=
Dejan Savićević=
Dragan Stojković=
Marko Van Basten=
Alfredo Di Stefano=
Ferenc Puškaš=
Franc Bekenbauer=
Paolo Rosi=

Holandija
Italija
Mađarska
Nemačka
Francuska
Crna Gora
Srbija
Argentina

*Liga šampiona u košarci
Panatinaikos=
CSKA Moskva=
Olimpijakos=
Partizan=
Kinder Bolonja=
Real Madrid=
Limož=
Makabi Tel Aviv=

1992
1997
2008
1998
1993
1995
2005
2000

*Osvajači lige šamiona u fudbalu
Barselona=
Real Madrid=
Dortmund=
Milan=
Liverpul=
Ajaks=
Mančester=
Bajern=

1994
2008
2005
2000
1992
1997
2001
1995

*Viski po gradovima
Johnnie Walker=
Ballantines=
Jack Daniels=
Jameson=
Chivas=
Grants=
Jim Beam=
J &amp; B=

Dumbarton (Škotska)
Kentaki (USA)
Daftaun (Škotska)
Dablin (Irska)
Aberdin (Škotska)
Tenesi (USA)
London (UK)
Kilmarnok (Škotska)

*Aerodromi
Nikola Tesla=
Ben Gurion=
Marko Polo=
Linate=
Vnukovo=
Ruzinje=
Tegel=
Džordž Best=

Milano
Belfast
Prag
Berlin
Beograd
Tel Aviv
Venecija
Moskva

*Glumci
Brus=
Džoni=
Bred=
Džordž=
Džeki=
Silvester=
Arnold=
Rodžer=

Stalone
Vilis
Mur
Čen
Dep
Kluni
Svarceneger
Pit

*Piva
Nik=
Lav=
Ožujsko=
Laško=
Guinness=
Bavaria=
Carlsberg=
Budweiser=

Holandija
Češka
Srbija
Crna Gora
Irska
Slovenija
Danska
Hrvatska

*Uloge u seriji Vratiće se rode
Nikola Đuričko=
Dragan Bjelogrlić=
Srđan Todorović=
Mira Banjac=
Branimir Brstina=
Miodrag Krivokapić=
Nikola Kojo=
Vojin Ćetković=

Vražalić
Batrić
Milenko
Švaba
Dule Pacov
Ekser
Baba Ruža
Sima

*Imena tenisera
Hjuit=
Sepi=
Safin=
Monfis=
Ivanišević=
Bozoljac=
Vemić=
Davidenko=

Gajl
Marat
Andreas
Goran
Dušan
Ilija
Nikolaj
Lejton

*Poznata alkoholna pića
Jack Daniels=
Tuborg=
Smirnoff=
Gordons=
Martell=
Two fingers=
Baccardi=
Sheridans=

džin
rum
konjak
pivo
viski
vodka
liker
tekila

*Poznati bračni parovi
Bred Pit=
Albert Ajnštajn=
Andre Agasi=
Ben Aflek=
Sil=
Toni Parker=
Dejvid Bouvi=
Nikola Sarkozi=

Dženifer Eniston
Iman
Dženifer Garner
Eva Longorija
Hajdi Klum
Štefi Graf
Mileva Marić
Karla Bruni

*Spoj poznate ličnosti sa njhovim zanimanjima
pevačica=
rukometaš=
modni kreator=
fudbaler=
političar=
manekenka=
glumica=
voditelj=

Tijana Stajšić
Dragan Marinković
Igor Butulija
Milica Majstorović
Ivica Dačić
Nemanja Vidić
Ana Vilenica
Verica Rakočević

*Hemijski elementi
Antimon=
Siborgijum=
Arsen=
Astat=
Argon=
Kalaj=
Iterbijum=
Itrijum=

At
As
Sg
Ar
Yb
Sn
Y
Sb

*Lekari specijalisti
dermatovenerolog=
pedijatar=
nefrolog=
neurolog=
otorinolaringolog=
pneumoftiziolog=
endokrinolog=
gastroenterolog=

žlezdani sistem
sistem za disanje
mokraćni sistem
dečje bolesti
sistem za varenje
uho, grlo, nos
živčani sistem
koža 

*Nadimci u filmovima
Srđan Todorović=
Sergej Trifunović=
Gordan Kicić=
Nebojša Glogovac=
Nikola Đuričko=
Dragan Bjelogrlić=
Nikola Kojo=
Boris Milivojević=

Fleka
Kure
Živac
Gojko Sisa
Pop
Tungi
Sumpor
Velja

*Turistička mesta na jadranu i njihov položaj 
Orebić=
Fazana=
Kupari=
Bijela=
Jelsa=
Supetar=
Rimini=
Przno=

Pelješac
Italija
Hvar
Konavli
Istra
Budvanska rivijera
Boka kotorska
Brač

*Filmski glumci negativci
Kad jaganjci utihnu=
Mračni vitez=
Terminator 2=
Autostoper=
Peti element=
Đavolji advokat=
Strava u ul.brestova=
Brzina=

Al Paćino
Entoni Hopkins
Denis Hoper
Gari Oldmen
Hit Ledžer
Šon Bin
Robert Englund
Robert Patrik

*rok grupe-pevači
Bad company=
Doors=
Led zeppelin=
Queen=
Foo fighters=
Pearl jam=
Metallica=
Deep purple=

Džim Morison
Džejms Hetfild
Edi Veder
Fredi Merkjuri
Dejvid Grol
Robert Plant
Jan Gilan
Pol Rodžers

*Vrste životinja
golub=
konj=
pas=
mačka=
svinja=
kokoška=
ribica=
ovca=

tipler
gupika
sijamska
kaporka
mangulica
buldog
lipicaner
đimeška

*Grčke  MUZE:
Talija=
Uranija=
Melpomena=
Polihimnija=
Erato=
Kaliopa=
Klio=
Euterpa=

astronomije
istorije
epske pesme
ozbiljne poezije
ljubavne lirike
tragedije
muzike
komedije

*Skijaši
Bodi=
Ivica=
Didije=
Natko=
Masimilijan=
Beni=
Aksel Lund=
Ingemar=

Rajh
Kostelić
Kuše
Svindal
Miler
Stenmark
Zrnčić Dim
Blardone

*Glumci
Dragan=
Nikola=
Sergej=
Petar=
Nebojša=
Bogdan=
Lazar=
Miki=

Diklić
Manojlović
Đuričko
Bjelogrlić
Glogovac
Kralj
Ristovski
Trifunović

*Pevačice
Severina=
Jelena=
Ceca=
Dragana=
Ivana=
Marija=
Hanka=
Nada=

Mirković
Topčagić
Šerifović
Paldum
Vučković
Tomašević
Ražnatović
Banfić

*Pevači
Željko=
Zdravko=
Dino=
Hari=
Haris=
Miroslav=
Halid=
Aca=

Bešlić
Ilić
Čolić
Lukas
Varešanović
Merlin
Džinović
Joksimović

*NBA Legende
Majkl=
Karim=
Karl=
Džon=
Skoti=
Čarls=
Hakim=
Ajzeja=

Džordan
Barkli
Stokton
Pipen
Abdul Džabar
Tomas
Maloun
Olajdžuvon

*Poznate svetske luke
Roterdam=
Durban=
Kingston=
Mumbaj=
Kartagena=
Geteborg=
Montevideo=
Nasau=

Holandija
Švedska
Indija
Kolumbija
Južna Afrika
Bahami
Jamajka
Urugvaj

*Fudbalska reprezentacija 1998
Dragan=
Dejan=
Predrag=
Slaviša=
Ljubinko=
Savo=
Vladimir=
Darko=

Milošević
Kovačević
Savićević
Stojković
Drulović
Jokanović
Jugović
Mijatović

*Poslovni giganti
Nokia=
Oracle=
Nestle=
Sony=
Stihl=
Bosch=
Audi=
Philip Morris=

televizor
cigarete
bela tehnika
automobil
mobilni telefon
poslovni softver
čokolada
motorna testera

*Gradonačelinici
Beograd=
Novi Sad=
Niš=
Kragujevac=
Subotica=
Leskovac=
Zrenjanin=
Kruševac=

Veroljub Stevanović
Desimir Pavlović
Slobodan Kocić
Mileta Mihajlov
Dragan Đilas
Igor Pavličić
Miloš Simonović
Saša Vučinić

*Frazeologizmi
Siguran kao=
S mene=
Ispod=
Obećavati zlatna=
Nemati dlake=
Odvojiti žito=
Naći zajednički=
Igrati se=

od kukolja
pa na uštap
žita
jezik
vrbov klin
vatrom
brda i doline
na jeziku

*Poznate ličnosti
Nebojša Glogovac=
Oliver Dulić=
Nemanja Vidić=
Toma Fila=
Svetislav Basara=
Milorad Milinković=
Radomir Mihailović=
Miodrag Stojković=

Glumac
Gitarista
Pisac
Fudbaler
Političar
Genetičar
Advokat
Režiser

*Televizijske emisije
Kvadratura kruga=
Nivo 23=
Vikend vizija=
Ja najbolje kuvam=
Insajder=
Fajront Republika=
Slike Života=
Budi faca=

FOX
Studio B
Pink
Avala
RTS
Košava
Most
B92

*Stadioni u Engleskoj
Stemford bridž=
Old traford=
Emirati=
Anfild=
Vajt hart lejn=
St. Džejms park=
Bolejn graund=
Vila park=

Totenhem
Aston vila
Njukasl
Liverpul
Mančester UTD
Čelsi
Vest Hem
Arsenal

*Indijanske poglavice i plemena
Apači=
Sijuksi=
Otava=
Koasati=
Čiroki=
Komanči=
Asteci=
Inke=

Montezuma
Zeleni Rog
Pontijak
Bik Koji Sedi
Atahualpa
Vilma Menkiler
Kolita
Džeronimo

*Sportisti
Milorad Čavić=
Dragutin Topić=
Uroš Tripković=
Filip Filipović=
Dejan Stanković=
Nikola Stojić=
Janko Tipsarević=
Momir Ilić=

Plivanje
Veslanje
Vaterpolo
Fudbal
Skok u vis
Rukomet
Košarka
Tenis

*Merne jedinice
1/1000000=
1/1000=
1/100=
1/10=
10=
100=
1000=
1000000=

mikro
hekto
deci
deka
mili
mega
centi
kilo

*Automobili
Volkswagen=
Audi=
Seat=
Toyota=
Suzuki=
Opel=
Fiat=
Renault=

Omega
Twingo
A8
Polo
Swift
Corolla
Punto
Cordoba

*Strane glumice i filmovi
Šeron Stoun=
Kameron Diaz=
Anđelina Žoli=
Penelope Kruz=
Šarliz Teron=
Mila Jovović=
Džulija Roberts=
Sigurni Viver=

Niske strasti
Erin Brokovič
Viki Kristina Barselona
Peti element
Đavolji advokat
Tomb Raider
Maska
Osmi putnik

*Čokolada i proizvođači
Milka=
Galeb=
Dorina=
Menaž=
Kinder=
Crunch=
Schogetten=
Twix=

Mars
Trumpf
Ferrero
Kraft foods
Kraš
Pionir
Soko Štark
Nestle

*Glavne muške uloge
Zelena milja=
Bekstvo iz šošenka=
Mračni vitez=
Kazablanka=
Bulevar sumraka=
Paklena pomorandža=
Ubiti pticu rugalicu=
Mali veliki čovek=

Malkolm Mekdauel
Tom Henks
Dastin Hofman
Vilijam Holden
Tim Robins
Hemfri Bogart
Gregori Pek
Kristijan Bejl

*Reke i gradovi
Morača=
Dunav=
Sava=
Miljacka=
Tara=
Vardar=
Morava=
Tisa=

Skopje
Bečej
Donji Milanovac
Podgorica
Kolašin
Sarajevo
ćuprija
Zagreb

*Strani glumci i filmovi
Arnold Švarceneger=
Kevin Spejsi=
Klint Istvud=
Bred Pit=
Leonardo DiKaprio=
Harison Ford=
Džoni Dep=
Vil Smit=

Dežurni krivci
Pirati Kariba
Indijana Džons
Troja
Avijatičar
Dobar, loš, zao
Dan nezavisnosti
Terminator

*Ostrva
Majorka=
Island=
Hvar=
Madagaskar=
Krf=
Jamajka=
Tasos=
Tahiti=

Egejsko more
Karipsko more
Jadransko more
Atlantik
Pacifik
Jonsko more
Indijski okean
Mediteran

*Dobitnici Oskara 2010
najbolji film=
strani film=
dokumentarac=
animirani=
adaptirani scenario=
kinematografija=
kostimografija=
 najbolja šminka=

Up
The Hurt Locker
Precious
Avatar
Star Trek
The Cove
The Young Victoria
The Secret in Their Eyes

*Navijači ex Yu klubova
Varvari=
Grobari=
Delije=
Torcida=
Armada=
Manijaci=
Horde zla=
Komiti=

Crvena Zvezda
Partizan
Sarajevo
Vardar
Rijeka
Željezničar
Hajduk
Budućnost

*EX YU Fudbalski klubovi
Budućnost=
Hajduk=
Olimpija=
Radnički=
Vardar=
Partizan=
Čelik=
Željezničar=

Podgorica
Zenica
Kragujevac
Beograd
Skopje
Ljubljana
Split
Sarajevo

*EX YU Stadioni
Čair=
Karaburma=
Bilino Polje=
Poljud=
Karađorđe=
Grbavica=
Kantrida=
Bežigrad=

Rijeka
Sarajevo
Zenica
Beograd
Ljubljana
Novi Sad
Split
Niš

*Odevni predmeti
ruka=
noge=
prst=
vrat=
uho=
stopalo=
glava=
oči=

sat
čarapa
lančić
minđuša
pantalone
naočare
burma
kapa

*likovi iz filma "lepa sela lepo gore"
brzi=
viljuška=
velja=
halil=
gvozden=
teta đana=
bolničarka=
učiteljica=

milica ostojić
zoran cvijanović
vera dedović
bata živojinović
milorad mandić manda
nikola pejaković
branka katić
nikola kojo

*Rok muzicari i njihove pesme.
The Doors=
Pink Floyd=
Led Zeppelin=
Jimi Hendrix=
Stivie Ray Vaughan=
Chris Rea=
Eric Clapton=
The Rolling Stones=

Jumpin' Jack Flash
Layla
The sky is crying
Love me two times
Whole lotta love
Money
Little wing
Road to hell

*Povežite države i glavne gradove
Eritreja=
Etiopija=
Zambija=
Zapadna Sahara=
Zelenortska republika=
Zimbabve=
Južnoafrička republika=
Kamerun=

Adis Abeba
Pretorija
Harare
El Ajun
Praja
Lusaka
Jaunde
Asmara

*Povežite države i glavne gradove
Francuska=
Holandija=
Hrvatska=
Crna Gora=
Češka=
Švajcarska=
Švedska=
Španija=

Bern
Amsterdam
Zagreb
Stokholm
Pariz
Madrid
Podgorica
Prag

*Praznici i datumi
Dan JNA=
Dan borca=
Dan pobede=
Dan Ujedinj.nacija=
Međunar.dan žena=
Svetski dan štednje=
Dan prava čoveka=
Dan željezničara=

31.X
15.IX
04.VII
22.XII
08.III
24.X
10.XII
09.V

*gradovi i pozivni brojevi
Priboj=
Irig=
Ljig=
Ivanjica=
Kanjiža=
Koceljevo=
Lebane=
Majdanpek=

015
033
030
024
022
032
016
014

*Pobednici Eurosonga i godine
2010=
2009=
2008=
2007=
2006=
2005=
2004=
2003=

Grčka - H.Paprizou
Norveška - A.Ribak
Rusija - Dima Bilan
Ukrajina - Ruslana
Nemačka - Lena
Turska - S.Erener
Srbija - M.Šerifović
Finska - Lordi

*Povežite države i glavne gradove
Republika Kongo=
Ruanda=
Sao Tome i Principe=
Svazilend=
Sejšeli=
Senegal=
Sijera Leone=
Somalija=

Mbabane
Sao Tome
Kigali
Viktorija
Fritaun
Dakar
Mogadiš
Brazavil

*Odbojkaši
Novica=
Nikola=
Ivan=
Đula=
Bojan=
Andrija=
Sasa=
Marko=

Starović
Gerić
Grbić
Podraščanin
Mešter
Miljković
Janić
Bjelica

*Titovi gradovi i republike/pokrajine
Titovo Užice=
Titov Veles=
Titograd=
Titova Mitrovica=
Titovo Velenje=
Titov Vrbas=
Titov Drvar=
Titova Korenica=

Crna Gora
Makedonija
Bosna i Hercegovina
Hrvatska
Slovenija
Vojvodina
Kosovo i Metohija
Srbija

*teniserke
Vera=
Elena=
Sabine=
Alisa=
Gisela=
Patty=
Jelena=
Ana=

Dementieva
Janković
Schnyder
Kleybanova
Dulko
Lisicki
Ivanović
Zvonareva

*teniseri
Roy=
Ivan=
John=
Andre=
Pete=
Boris=
Novak=
Jeremy=

Becker
Emerson
Chardy
Sampras
Lendl
Agasi
Đoković
McEnroe

*Stadioni fudbalskih klubova
Kamp Nou=
Mestaja=
Old Traford=
Velodrom=
Zerlan=
Olimpiko=
Dragao=
Enfild=

Olimpik Marsej
Mančester j.
Valensija
Olimpik Lion
Porto
Roma
Liverpul
Barselona

*Piva i gradovi iz kojih potiču
Jelen=
Lav=
Nik=
Ožujsko=
Pilsner Urquell=
Amstel=
Budweiser Budvar=
Kamenitza=

Plovdiv
České Budějovice
Plzen
Apatin
Nikšić
Čelarevo
Zagreb
Amsterdam

*Epovi
Ep o Gilgamesu=
Eda=
Kalevala=
Beovulf=
Kebra Nagast=
Pesma o Rolanu=
Spev o Sidu=
Kaleviopea=

Engleski
Estonski
Francuski
Spanski
Sumersko-vavilonski
Islandski
Finski
Etiopijski

*Fobije
Ergofobija=
Hodofobija=
Pedofobija=
Niktofobija=
Hipofobija=
Ginekofobija=
Hrematofobija=
Ombrofobija=

deca
putovanje
novac
kisa
konji
zene
mrak
rad

*Glavni gradovi J.Amerike
Argentina=
Čile=
Peru=
Urugvaj=
Surinam=
Ekvador=
Bolivija=
Paragvaj=

Montevideo
Asunsion
Kito
La Paz
Buenos Ajres
Santijago
Lima
Paramaribo

*Pisci i njihova dela
Branko Ćopić=
Mihailo Lalić=
Milorad Pavić=
Meša Selimović=
Ivo Andrić=
Janko Veselinović=
Simo Matavulj=
Milovan Vitezović=

Predeo slikan čajem
Svadba
Bakonja fra Brne
Lajanje na zvezde
Prokleta avlija
Hajduk Stanko
Tvrđava
Prolom

*Partneri u crtanim filmovima
Tom=
Popaj=
Ptica Trkačica=
Sunđer Bob=
Miki=
Silvester=
Duško Dugouško=
Kremenko=

Tviti
Badža
Pera Kojot
Patak Dača
Džeri
Kamenko
Patrik
Šilja

*Povežite države i glavne gradove
Maroko=
Mauritanija=
Mauricijus=
Mozambik=
Namibija=
Niger=
Nigerija=
Obala Slonovače=

Vindhuk
Jamasukro
Niamej
Maputo
Nuakšot
Rabat
Abudža
Port Luis

*Stara imena država
Zlatna obala=
Abisinija=
Kampučija=
Afar i  Isa=
Besarabija=
Severna Rodezija=
Britanski Honduras=
Njasalend=

Gana
Belize
Moldavija
Kambodža
Etiopija
Malavi
Džibuti
Zambija

*Serije
Povratak=
Bolji=
Vruć=
Alo=
Balkan=
Bela=
Srećni=
Porodično=

Alo
Blago
Lađa
Ljudi
Otpisanih
Život
Vetar
Ekspres

*Knjige i pisci
Sex i grad=
Koliba=
Pali andjeli=
Prava porodica=
Digitalna tvrdjava=
Kraj leta=
Kupoholicarka=
Alhemicar=

Kendas Busnel
Sofi Kinsela
Toni Parsons
Danijela Stil
Den Braun
Trejsi Sevalije
Vilijem Pol Jang
Paulo Koeljo

*Suprotnosti
+100=
6/7=
1/5=
0/10=
3+4=
10*20=
4 na kvadrat=
7-3=

-100
200
beskonačno
4+3
7/6
-4
5
16

*Narodne poslovice
bolje vrabac u ruci=
ispeci=
ko drugome jamu kopa=
bez alata=
tiha voda=
gde je stida=
ko radi=
ko rano rani=

nema ni zanata
sam u nju pada
pa reci
breg roni
ne boji se gladi
tu je i poštenja
dve sreće grabi
nego golub na grani

*Glumci i filmovi
Rasel Krou=
Bred Pit=
Harison Ford=
Nikola Đuričko=
Dragan Bjelogrlić=
Morgan Friman=
Brus Vilis=
Kolin Farel=

Mrtav Ladan
Umri muški
Lepa sela lepo gore
Troja
Gladijator
Indijana Džouns
Aleksandar
Bekstvo iz Šoušenka

*Engleske reči
Hammer=
Car=
Cat=
Ball=
Head=
Heart=
Brain=
Train=

Glava
Voz
Srce
Lopta
Auto
Čekić
Mozak
Mačka

*Kompanije
Simens=
Fiat=
Nestle=
Gazprom=
TAU=
Frikom=
Tojota=
Nokia=

Nemačka
Srbija
Rusija
Španija
Italija
Finska
Švajcarska
Japan

*Evropski gradovi
Hag=
Malme=
Limasol=
Rimini=
Štutgart=
Salcburg=
Tivat=
Dubrovnik=

Švedska
Crna Gora
Austrija
Italija
Nemačka
Kipar
Hrvatska
Holandija

*Glavni gradovi
Bogota=
Lima=
Dakar=
Rijad=
Islamabad=
Montevideo=
Berlin=
Varšava=

Saudijska Arabija
Senegal
Peru
Pakistan
Nemačka
Urugvaj
Poljska
Kolumbija

*Pisci
Don Kihot=
Robinzon Kruso=
Gospodar prstenova=
Alhemičar=
Ime ruže=
Rat i Mir=
Romeo i Julija=
Hari Poter=

J.K. Rovling
V. Šekspir
U. Eko
M. de Cervantes
J.R.R. Tolkin
D. Defo
P. Koeljo
L. Tolstoj

*NBA ekipe
Majami=
Detroit=
Milvoki=
Toronto=
Indijana=
Minesota=
Nju Oreleans=
Juta=

Hornets
Timbervulfs
Pistons
Džez
Reptors
Baks
Pejsers
Hit

*Klubovi iz Nemačke
Verder=
Bajer=
Bajern=
Borusija=
Herta=
Šalke=
Ajntraht=
Dinamo=

Frakfurt
Gelsenkirhen
Minhen
Leverkuzen
Drezden
Berlin
Dortmund
Bremen

*Povežite države i glavne gradove
Gambija=
Gana=
Gvineja=
Gvineja Bisao=
DR Kongo=
Egipat=
Ekvatorijalna Gvineja=
Eritreja=

Bisau
Banjul
Kinšasa
Kairo
Asmara
Konakri
Malabo
Akra

*Evropski fudbalski klubovi
Fiorentina=
Bajer=
Espanjol=
Galatasaraj=
Sporting=
Everton=
Dinamo=
Lokomotiva=

Firenca
Livepul
Istanbul
Lisabon
Leverkuzen
Moskva
Barselona
Kijev

*NBA Košarkaši
LeBron=
Karmelo=
Kris=
Dvajt=
Dirk=
Tim=
Džo=
Dvejn=

Boš
Antoni
Džonson
Vejd
Novicki
Dankan
Hauard
Džejms

*Reke
Morača=
Neretva=
 Velika Morava=
Volga=
Dnjepar=
Amazon=
Nil=
Rajna=

Ukrajina
Nemačka
Brazil
Rusija
Bosna i Hercegovina
Crna Gora
Egipat
Srbija

*Planine
Avala=
Komovi=
Belasica=
Triglav=
Jahorina=
Ural=
Velebit=
Pirin=

Rusija
Crna Gora
Makedonija
Hrvatska
Srbija
Bugarska
Slovenija
Bosna i Hercegovina

*Bivši fudbalski asovi
Roberto=
Zinedin=
Didijer=
Đanfranko=
Đanluka=
Marko=
Dino=
Karlos=

Carlos
Zof
Vijali
Dešamp
Zidan
Dunga
Zola
Van Basten

*Rukomet
Žarko=
Momir=
Ivan=
Dejan=
Darko=
Dimitrije=
Alem=
Nenad=

Perić
Toskić
Stanić
Ilić
Šešum
Nikčević
Vučković
Pejanović

*Račun i rešenje
1 + 1 * 1 + 1=
2 + 2=
3 * 3=
4 * 4 - ( 4 + 4 )=
5 / 5=
6 + 6 / 6=
( 7 + 7 ) / 7=
8 - 8=

2
7
4
0
8
9
1
3

*Film i Godina kada je dobio Oskara
Zaljubljeni Šekspir=
Ben Hur=
Kad jaganjci utihnu=
Odred (Platoon)=
Gandi=
Hrabro Srce=
Let iznad kukavičjeg gnezda=
Forest Gamp=

1960
1976
1996
1987
1983
1992
1995
1999

*Povežite države i glavne gradove
Kenija=
Komori=
Lesoto=
Liberija=
Libija=
Madagaskar=
Malavi=
Mali=

Antananarivo
Najrobi
Bamako
Tripoli
Moroni
Monrovija
Lilongve
Maseru

*Emisije i televizije
Kvadratura kruga=
City kids=
Fajront republika=
Total soccer=
Insajder=
Pressovanje=
Još uvek budni=
Svaštarica=

RTS
Studio B
B92
TV Fox
TV Pink
TV Avala
Sos kanal
Happy TV

*Glumci/Glumice i Filmovi
Nicolas Cage=
Julia Roberts=
Nastasja Kinski=
Denzel Washington=
Tom Hanks=
Cameron Diaz=
Sharon Stone=
Monica Bellucci=

Faraway, So Close
Runaway Bride
The Muse
Shoot 'Em Up
The Ladykillers
Mask
John Q
Leaving Las Vegas

*Svetski šampioni 2002
Dejan=
Vlade=
Milan=
Marko=
Predrag=
Igor=
Vladimir=
Žarko=

Čabarkapa
Radmanović
Stojaković
Bodiroga
Gurović
Divac
Jarić
Rakočević

*režiseri i filmovi
Slobodan Šijan=
Darko Bajić=
Vatroslav Mimica=
Hajrudin Krvavac=
Želimir Žilnik=
Dušan Makavejev=
Goran Paskaljević=
Zdravko Šotra=

Banović Strahinja
Direktan prenos
Poseban tretman
Osvajanje slobode
Rani radovi
Misterije organizma
Most
Tajna manastirske rakije

*Najbolji strelci mundijala 
ronaldo=
gerd miler=
mario kempes=
žist fonten=
leonidas=
eusebio=
hristo stoičkov=
davor šuker=

1978
1970
1994
1998
1938
1966
1958
2002

*Rase pasa
Sibirski=
Zlatni=
Patuljasti=
Kineski=
Vojvođanski=
Irski=
Nemački=
Jorkširski=

Terijer
Bokser
Pulin
Haski
Šnaucer
Retriver
Pekinezer
Seter

*Teniseri i zemlje:
Španija=
Čile=
Škotska=
Švajcarska=
Engleska=
Australija=
Francuska=
SAD=

Mardi Fiš
Zo Vilfrid Conga
Tim Henman
Fernando Verdasko
Endi Mari
Fernando Gonzales
Rodžer Federer
Pol Henli

*TENISERI i TENISERKE
Novak=
David=
Fernando=
Justine=
Vera=
Marion=
Daniel=
Elena=

Bartoli
Đoković
Dementieva
Zvonareva
Ferrer
Henin
Nestor
Gonzales

*Nova svetska čuda
Veliki zid=
Čičen Ica=
Hrist Spasitelj=
Maču Pikču=
Petra=
Koloseum=
Tadž Mahal=
Kip Slobode=

Kina
Italija
Peru
Jordan
Meksiko
SAD
Brazil
Indija

*Povežite države i glavne gradove
Alžir=
Angola=
Benin=
Botsvana=
Burkina Faso=
Burundi=
Gabon=
Gambija=

Gaborone
Alžir
Uagadugu
Budžumbura
Banjul
Porto Novo
Librevil
Luanda

*Proizvođači i proizvodi
nestle=
pionir=
marbo=
štark=
bambi=
sl takovo=
banini=
kraš=

euroblok 
galeb čokolada
pardon štapići
noblice
nes kafa
bronhi
smoki
plazma keks

*Parlamenti
Duma=
Storting=
Kneset=
Kortes=
Skupština=
Sobranje=
Vrhovna Rada=
Holirud=

Srbija
Škotska
Bugarska
Portugal
Norveška
Rusija
Ukrajina
Izrael

*Teniserke i države
Maria Kirilenko=
Melanie Oudin=
Alona Bondarenko=
Gisela Dulko=
Sibyle Bammer=
Jelena Janković=
Justine Henan=
Cara Black=

Ukrajina
SAD
Belgija
Zimbabve
Austrija
Srbija
Argentina
Rusija

*Književnici i dela
Miroslav Krleža=
Fjodor M Dostojevski=
Mihail Šolohov=
August Šenoa=
Ernest Hemingvej=
Maksim Gorki=
Anton P. Čehov=
Vladimir Nazor=

Seljačka buna
Tihi Don
Zločin i kazna
Zbogom oružje
Ujka Vanja
Među ljudima
Legende o drugu Titu
Gospoda Glembajevi

*Najveća rivalstva u fudbalu
Milan=
Barcelona=
Zvezda=
Boca Juniors=
Seltik=
Manchester Utd=
Ajax=
Bajern=

Inter
PSV
Rangers
Partizan
Real Madrid
Werder
River Plate
Liverpool

*Države i predsednici
Slovačka=
Slovenija=
Rumunija=
Češka=
Crna Gora=
Makedonija=
Hrvatska=
Albanija=

bamir topi
ivo josipović
filip vujanović
ivan gasparović
trajan basesku
danilo tirk
vaclav klaus
đorđe ivanov

*Filmovi i glumci
poslednja analiza=
upoznaj roditelje=
sabrina=
dan nezavisnosti=
sirijana=
borilački klub=
igra=
barska mušica=

bred pit
ričard gir
miki rurk
džordž kluni
robert de niro
vil smit
majkl daglas
harison ford

*filmovi i glumci
Kad jaganjci utihnu=
Jesen u Njujorku=
Anakonda=
Maćeha=
Osmi putnik=
Hič=
Peti Element=
Izgubljeni u prevodu=

Eva Mendez
Vinona Rajder
Dženifer Lopez
Mila Jovović
Džodi Foster
Skarlet Johanson
Džulija Roberts
Sigurni Viver

*Spojite države bivše SSSR i njihove glavne gradove
Azerbejdžan=
Belorusija=
Gruzija=
Estonija=
Letonija=
Litvanija=
Kazahstan=
Kirgistan=

Baku
Viljnus
Talin
Riga
Minsk
Biškek
Tbilisi
Astana

*Žene u pesmama
Anita=
Suada=
Marina=
Marija=
Tamara=
Selma=
Nataša=
Sanja=

Plavi orkestar
P. I. L.
Bijelo dugme
Divlje jagode
Boris Novković
Prljavo kazaliste
Alisa
Đorđe Balašević

*filmovi i glumci
rikoset=
miris žene=
dik i džejn=
petar pan=
pukotina=
mrtav čovek hoda=
blistavi um=
čitač=

entoni hopkins
ralf fajns
šon pen
robin vilijams
al paćino
denzel vošington
rasel krou
džim keri

*Spojite srpske političare i njihova rodna mesta
Boris Tadić=
Tomislav Nikolić=
Velimir Ilić=
Nenad Čanak=
Vuk Drašković=
Tomica Milosavljević=
Žarko Obradović=
Milutin Mrkonjić=

Kruševac
Sarajevo
Beograd
Međa
Kragujevac
Pančevo
Berane
Čačak

*Fudbalski klubovi i stadioni na kojima igraju
arsenal=
mančester siti=
mančester junajted=
liverpul=
njukasl=
aston vila=
čelsi=
bolton=

enfild roud
ribok arena
vila park
stamford bridž
emirati
istlend
old traford
sent džejms park

*Pesme i izvođači
generacija 5=
yu grupa=
galija=
riblja čorba=
van gogh=
ekv=
osvajači=
partibrejkers=

pesma za dobro jutro
mornar
pronađi me
dugo te nema
opasan ples
srce
dobro jutro
soba hotela

*Pesnici i pesme
M.Antić=
D.Radović=
D.Maksimović=
J.Dučić=
T.Ujević=
D.Konstantinović=
B.Miljković=
D.Erić=

Strepnja
Mali život
Uzalud je budim
Pismo učitelju
Misao na nju
Želja
Pesma ženi
Nosač

*Knjige i autori
Kalifornija bluz=
Žudnja za životom=
Mamac=
Jelena=
Da Vinčijev kod=
Gospodar prstenova=
Prohujalo s vihorom=
Memoari jedne gejše=

Margaret Mičel
Džon RR Tolkin
Irving Stoun
Artur Golden
Mile Kordić
David Albahari
Den Braun
Milan Oklopčić

*Grčki bogovi
Posejdon=bog mora
Demetra=boginja žita
Artemida=boginja lova
Hera=zaštitnica braka
Kron=bog vremena
Nika=boginja trijumfa
Hermes=bog trgovine
Morfej=bog sna

*Povežite Nobelovce sa godinama koje su dobili nagradu
1951.=
1952.=
1953.=
1954.=
1955.=
1956.=
1957.=
1958.=

Huan Ramon Himenes
Boris Pasternak
Fransoa Morijak
Per Lagerkvist
Haldor Laksnes
Ernest Hemingvej
Alber Kami
Vinston Čerčil

*Glumci i filmovi
Život sa Helen=
Rat Ruža=
Plava Laguna=
Dok budan sanjam=
Lov na crv. oktobar=
8. putnik=
Specijalitet kuće=
Ludačka košulja=

Šon Koneri
Edrijan Brodi
Sigurni Viver
Robin Vilijams
Ketlin Tarner
Kejt Hadson
Havijer Kamara
Bruk Šilds

*Imena pobednika formule 1
Šumaher=Mihael
Fandjo=Huan Manuel
Prost=Alan
Lauda=Niki
Pike=Nelson
Alonso=Fernando
Fitipaldi=Emerson
Klark=Džim

*Nirberški proces
Martin=Borman
Albert=Šper
Joakim=Fon Ribentrop
Alfred=Jodl
Rudolf=Hes
Herman=Gering
Vilhelm=Frih
Karl=Denic

*Spojite pisce i pripovetke
Ivo Andrić=
Laza Lazarević=
Đura Jakšić=
Milovan Glišić=
Radoje Domanović=
Petar Kočić=
Svetolik Ranković=
Stevan Sremac=

Stari vruskavac
Jazavac pred sudom
Na bunaru
Božićna pečenica
Ni oko šta
Sirota Banaćanka
Danga
Ljubav u kasabi

*Evropske države i prestonice
Italija=Rim
Letonija=Riga
Kipar=Nikozija
Bugarska=Sofija
San Marino=San Marino
Grčka=Atina
Litvanija=Vilnus
Belorusija=Minsk

*žene političari i države
Izabela Peron=Argentina
Margaret Tačer=V.Britanija
Jadranka Kosor=Hrvatska
Indira Gandi=Indija
Angela Merkel=Nemačka
Vesna Pešić=Srbija
Madlen Olbrajt=SAD
Julija Timošenko=Ukrajina

*Oblast proučavanja sledećih nauka je:
Oditologija=Putovanja
Mirmekologija=Mravi
Mikologija=Gljive
Nosologija=Bolesti
Kinologija=Psi
Osmologija=Mirisi
Ofidiologija=Zmije
Hipologija=Konji

*Povežite imena i prezimena čuvenih šahista:
Zigbert=
Savijeli=
Aleksandar=
Frenk=
Milan=
Rihard=
Salo=
Aron=

Taraš
Reti
Maršal
Vidmar
Tartakover
Nimcovič
Aljehin
Flor

*Kom horoskopskom znaku pripada datum
3.februar=
10.mart=
13.maj=
28.maj=
27.juli=
3.septembar=
9.oktobar=
31.decembar=

riba
vaga
devica
blizanci
lav
bik
jarac
vodolija

*Iz kojih jezika je poreklo sledećih reči
Kecelja=
Kašika=
Kontakt=
Matineja=
Vikend=
Šuster=
Mačeta=
Dukat=

Francuski
Mađarski
Engleski
Nemački
Talijanski
Latinski
Španski
Turski

*Stari nazivi zanata
đumrugdžija=carinik
mutavdžija=tkač
kujundžija=zlatar
kubikaš=kopač
pudar=čuvar vinograda
sakadžija=raznosač vode
tatarin=poštar
terzija=krojač

*Pisci i dela
Petar Kočić=Jazavac pred sudom
Branko Ćopić=Osma ofanziva
Đura Jakšić=Na Liparu
Dobrica Ćosić=Deobe
Desanka Maksimović=Miris zemlje
Miloš Crnjanski=Seobe
Branko Radičević=Đački rastanak
Branislav Nušić=Sumnjivo lice

*Države i glavni gradovi
Portugal=Lisabon
Litvanija=Viljnjus
Jermenija=Jerevan
Kipar=Nikozija
Gruzija=Tbilisi
Estonija=Talin
Letonija=Riga
Malta=Valeta

*Slikari i dela
Uroš Predić=Kosovka devojka
Paja Jovanović=Dama pored kamina
Nadežda Petrović=Bavarac sa šeširom
Sava Šumanović=Drvored
Milan Konjović=Plava Venera
Jasminka Konjević=
Rade Kačarević=
Katarina Radenković=

mlin
pevanje na kiši
ljubičasti buket

*Okruzi Republike Srbije i njihovi administrativni centri
Zapadnobački=Sombor
Južnobanatski=Pančevo
Kolubarski=Valjevo
Pomoravski=Jagodina
Moravički=Čačak
Toplički=Prokuplje
Raški=Kraljevo
Braničevski=Požarevac
Zlatiborski=Užice
Jablanički=Leskovac
Južnobački=Novi Sad
Mačvanski=Šabac
Podunavski=Smederevo
Pčinjski=Vranje
Rasinski=Kruševac
Severnobanatski=Kikinda
Severnobački=Subotica
Srenjobanatski=Zrenjanin
Sremski=Sremska Mitrovica
Šumadijski=Kragujevac	
#http://sr.wikipedia.org/sr-el/%D0%90%D0%B4%D0%BC%D0%B8%D0%BD%D0%B8%D1%81%D1%82%D1%80%D0%B0%D1%82%D0%B8%D0%B2%D0%BD%D0%B0_%D0%BF%D0%BE%D0%B4%D0%B5%D0%BB%D0%B0_%D0%A1%D1%80%D0%B1%D0%B8%D1%98%D0%B5

*Hormoni i organi
dopamin=hipotalamus
serotonin=centralni nervni sistem
insulin=pankreas
sekretin=dvanaestopalačno crevo
eritropoietin=bubreg
atriopeptin=srce
kalkitonin=tiroidna žlezda
melatonin=epifiza
adrenalin=nadbubrežna žlezda
testosteron=testisi
esteron=jajnici
#http://sh.wikipedia.org/wiki/Hormoni

*Fudbaleri (iz pesme grupe Neki Paori) i države porekla
Huntelar=Holandija
Kanavaro=Italija
Figo=Portugal
Mutu=Rumunija
Anelka=Francuska
Batistuta=Argentina
Roberto Karlos=Brazil
Guti=Španija

*Teniseri i države
Rodik=SAD
Del Potro=Argentina
Marej=Velika Britanija
Conga=Francuska
Nadal=Španija
Federer=Švajcarska
Davidenko=Rusija
Soderling=Švedska

*Povezi članove sa grupom
Film=Jura Stublić
Smak=Boris Aranđelović
Atomsko sklonište=Bruno Langer
Ruž=Vuk Rosandić
Crvena Jabuka=Dražen Zerić
Crno vino=Igor Žerajić
Crni biseri=Goran Vukićević
Haustor=Darko Rundek

*Pesme i izvođači
Osvajači=
Crvena Jabuka=
Bijelo Dugme=
Riblja Čorba=Ostani đubre do kraja
Bajaga=
Van Gogh=
Knock Out=
Smak=

Duša kad izneveri
Ne budi lud
Moji drugovi
Loše vino
Tugo, nesrećo
Crna dama
Puls

*Povežite ostrva sa morima i okeanima
Indijski okean=Sejšeli
Atlantski okean=Nantuket
Tihi okean=Fidži
Karipsko more=Kajmanska ostrva
Crno more=Zmijsko ostrvo
Mramorno more=Prinčevska ostrva
Egejsko more=Saronska ostrva
Sredozemno more=Sicilija

*Književnici i dela
Miroslav Antić=Plavi čuperak
Dobrica Ćosić=Vreme smrti
Janko Veselinović=Hajduk Stanko
Petar Petrović=Gorski Vijenac
Jovan Sterija Popović=Pokondirena tikva
Ivo Andrić=Travnička hronika
Jovan Jovanović-Zmaj=Đulići uveoci
Vuk Karadžić=Srpski rečnik

*Zaštićena i generička imena lekova
lasix=furosemid
prilenap=enalapril
bensedin=diazepam
ksalol=alprazolam
milenol=karvedilol
cholipam=simvastatin
movalis=meloksikam
norvasc=amlodipin

*Klubovi iz Španije
Espanjol=
Atletiko=
Deportivo=
Sosijedad=
Atletik=
Betis=
Rasing=
Osasuna=

San Sebastian
Barselona
Bilbao
Sevilja
Pamplona
La Korunja
Santander
Madrid

*Značenje hrvatskih reči
hrenovke=
hripavica=
juha=
kapljevina=
kat=
klokan=
kopar=
kositar=

tečnost
viršle
sprat
kengur
kalaj
supa
mirođija
kijavica

*Značenje hrvatskih reči
crvenilo=
časnik=
dražba=
dušik=
glačalo=
glazba=
gospodarstvo=
hlače=

ruž
muzika
azot
pegla
oficir
pantalone
aukcija
ekonomija

*Povežite nazive slika
Mlade=
Tajna=
Noćna=
Jevrejska=
Dečak=
Mlada=
Gola=
Porodica=

mlada
akrobata
i mladoženja
Maja
plemkinje
večera
straža
sa lulom

*Povežite imena Nobelovaca
Romen=
Sili=
Bjernstjerne=
Henrik=
Selma=
Herman=Hese
Karl=
Teodor=

Špiteler
Pridom
Momzen
Pontopidan
Bernson
Lagerlef
Rolan

*Povežite poznate slikare i njihova dela
Edouard Manet=
Vincent van Gogh=
Albrecht Durer=
Paul Gauguin=
Leonardo da Vinci=Mona Lisa
Paja Jovanović=
Đura Jakšić=
Francisco Goya=

Gola Maja
Devojka u plavom
Doručak na travi
Poklonjenje mudraca
Suncokreti
Dvije Tahićanke
Seoba Srba

*Hemijski elementi i njihove oznake
Kalaj=
Vanadijum=
Hrom=
Kadmijum=
Volfram=
Kripton=
Kirijum=
Kalijum=

Kr
K
V
Sn
W
Cd
Cm
Cr

*Grupe i njihove pesme
Šarlo Akrobata=
Galija=
Pop Mašina=
Idoli=
Babe=
Električni orgazam=
Korni Grupa=
Del Arno Band=

Čamac na Tisi
Jedna žena
Parodija života
Ona se budi
Put ka Suncu
Da li si sanjala
Stranac u noći
Debela devojka

*Ličnosti i predmeti
PIGMALION=
SIZIF=
AGATA KRISTI=
POSEJDON=
DAVID=
KRISTOFOR KOLUMBO=
ALBREHT DIRER=
ARHIMED=

SLONOVA KOST
MONOKL
TROZUBAC
PRAĆKA
KAMEN
KRUGOVI
MIŠOLOVKA
MAGIČNI KVADRAT

*Grupe i njihove pesme
Van Gogh=
Yu Grupa=
Tina=
Eva Braun=
Smak=
Riblja Čorba=
EKV=
S Vremena Na Vreme=

Zmajevi
Loza
More
Satelit
Anestezija
Egoista
Vašar
Delfin

*Žene u pesmama
Haustor=
S Vremena Na Vreme=
Bijelo Dugme=
Tunel=
Đorđe Balašević=
Buldožer=
Alisa=
Parni Valjak=

Selma
Jana
Sanja
Neda
Ljerka
Helga
Natali
Ena

*Ruski pisci i njihova dela
Mihail Bulgakov=
Mihail Šolohov=
Josif Brodski=
Anton Čehov=
Fjodor Dostojevski=
Ivan Bunjin=
Aleksandar Puškin=
Boris Pasternak=

Bela garda
Kavkaski zatvorenik
Kockar
Stanica u pustinji
Uzorana ledina
Doktor Živago
Višnjik
Život Arsenjeva

*Mešanje boja:
crvena i žuta=
plava i crvena=
plava i žuta=
zelena i plava=
crna i bela=
crvena i bela=
crna i plava=
crna i crvena=

roze
ljubičasta
zelena
indigo
narandžasta
trula višnja
tirkizna
siva

*Grčki alfabet
Alfa=
Beta=
Gama=
Delta=
Sigma=
Lambda=
Omega=
Pi=

?
?
?
?
?
?
?
?

*Planine i države u kojima se nalaze
Ardeni=
Osogovo=
Pind=
Harc=
Čakor=
Vidova Gora=
Borja=
Pohorje=

Bosna i Hercegovina
Hrvatska
Grčka
Bugarska
Slovenija
Crna Gora
Nemačka
Belgija

*Izvođaci i pesme
Sade=
Billy Idol=
Bee Gees=
Robbie Williams=
Britney Spears=
Depeche Mode=
Deep Purple=
Janis Joplin=

Tripping
Grease Theme
Mony Mony
Womanizer
Lalena
Enjoy the silence
Crazy on you
Lovers Rock

*Pisci i romani
Lav Tolstoj=
Ivan Turgenjev=
Erik Remark=
Fjodor Dostojevski=
Herman Hese=
Tomas Man=
Gustav Flober=
Leonid Andrejev=

Nečiste sile
Satanin dnevnik
Bundenbrokovi
Gospodja Bovari
Smrt Ivana Iljiča
Očevi i deca
Tri ratna druga
Stepski vuk

*Životinje iz crtaća
Nemo=
Džeri=
Silvester=
Patrik=
Rafaelo=
Pera=
Paja=
Balu=

Kojot
Miš
Mačak
Patak
Ribica
Medved
Morska zvezda
Kornjača

*Pop pesme i izvođači
Reci mi u lice=
Mila=
Sva od sna=
Žena za sva vremena=
Više te nema=
Anđele=
Kad zena zavoli=
Veži me za sebe=

Sergej Cetkovic
Toni Cetinski
Bojan Marović
Željko Vasić
Saša Kovačević
Toše Proeski
Željko Joksimović
Vlado Georgijev

*BUBNJARI
Niko McBrain=
Kristof Schneider=
Vicko Milatović=
Matt Sorum=
Srđan Todorović=
John Dolmayan=
Anders Johansson=
Vinnie Paul=

Hammerfall
System of a down
Riblja Čorba
Rammstein
Pantera
EKV
Guns n Roses
Iron Maiden

*ULOGE U SERIJI SRECNI LJUDI
VUKAŠIN=
LOLA=
ĐINA=
RISKA=
MALINA=
GARAC=
ANTONIJA=
ŠĆEPAN=

ŽIKA MILENKOVIĆ
DANILO LAZOVIĆ
TANJA BOŠKOVIĆ
DESIMIR STANOJEVIĆ
SNEŽANA SAVIĆ
RADMILA SAVIĆEVIĆ
SVETLANA BOJKOVIĆ
JUGOSLAVA DRAŠKOVIĆ

*Značenje hrvatskih reči
kovina=
kralježnica=
križaljka=
lašiti=
lice=
ljestve=
mjerilo=
mirovina=

merdevine
kičma
ukrštenica
razmera
metal
penzija
polirati
obraz

*Književnice i knjige
ANABELA BASALO=
MILICA JANKOVIĆ=
ISIDORA BJELICA=
MARIJA JOVANOVIĆ=
VESNA RADUSINOVIĆ=
SIMONIDA STANKOVIĆ=
LJILJANA H.ĐUROVIĆ=
IVANA KUZMANOVIĆ=

KRALJICE SERBSKE
PLAVA GOSPOĐA
IVA
MANJE OD 3
SRCE OD SILIKONA
GRABLJIVICA
DOVOLJAN RAZLOG
TAJNE ŽENSKIH JASTUKA

*Gradovi - Reke
Bečej=
Šabac=
Lazarevac=
Užice=
Zrenjanin=
Leskovac=
Kragujevac=
Smederevo=

Lepenica
Veternica
Kolubara
Sava
Dunav
Begej
Đetinja
Tisa

*NBA Timovi
Atlanta=
Boston=
New Jersey=
Chicago=
Miami=
Minnesota=
Detroit=
Oklahoma City=

Timberwolves
Hawks
Thunder
Heat
Celtics
Bulls
Pistons
Nets

*Domaćini svetskih prvenstava u fudbalu
URUGVAJ=
BRAZIL=
ŠVEDSKA=
ENGLESKA=
NEMAČKA=
ŠPANIJA=
ITALIJA=
FRANCUSKA=

1990
1982
1958
1950
1998
1974
1966
1930

*Pesme i izvođači
Junior Jack=
Sick and tired=
Baby one more time=
Earth song=
Otherside=
Space dementia=
Candyman=
American life=

Anastacia
Christina Aguilera
Muse
Michael Jackson
RHCP
Britney Spears
Madonna
Stupidisco

*Muzika i kompozitori
Muzika na vodi=
Mala noćna muzika=
Herojska poloneza=
Vltava=
Italijanski koncert=
Godišnja doba=
Sonata Mesečina=
Basso ostinato=

Betoven
Vivaldi
Mocart
Ščedrin
Smetana
Šopen
Bah
Hendl

*Spojite severnoameričke indijanske poglavice sa plemenima kojma pripadaju:
Pontijak=
Sijetl=
Ludi Konj=
Bik Koji Sedi=
Džeronimo=
Kvanah Parker=
Hijavata=
Crno Stopalo=

Kvahada Komanči
Otava
Vrane
Apači
Sukvamiš i Duvamiš
Hunkpapa Sijuksi
Mohavk
Oglala Sijuksi

*Gradovi i države
Kork Siti=
Ipsvič=
Ulm=
Utreht=
Krakov=
Udine=
Ćustendil=
Avr=

Italija
Francuska
Engleska
Irska
Poljska
Holandija
Bugarska
Nemačka

*Fudbalski klubovi i gradovi
Selta=
Benfika=
Espanjol=
Rasing=
Fejnord=
Vitese=
Evetron=
Aston Vila=

Santander
Barselona
Lisabon
Roterdam
Liverpul
Arnhem
Birmingem
Vigo

*Povežite dramske pisce i njihova dela:
Aleksandar Popović=
Biljana Srbljanović=
Ljubomir Simović=
Stevan Koprivica=
Siniša Kovačević=
Nenad Prokić=
Dejan Dukovski=
Dušan Kovačević=

Mrešćenje šarana
Bure baruta
Đeneral Milan Nedić
Čudo u Šarganu
Beogradska trilogija
Doktor Šuster
Bokeški D-mol
Metastabilni Graal

*Teniserke
Kim=
Ana=
Bojana=
Jelena=
Martina=
Serena=
Žastin=
Marija=

Vilijams
Klajsters
Šarapova
Navratilova
Ivanović
Janković
Enan
Jovanovski

*Pisci i dela
Ivo Andrić=
Radoje Domanović=
Miloš Crnjanski=
Isidora Sekulić=
Laza Lazarević=
Dobrica Ćosić=
Petar Kočić=
Jovan S. Popović=

Hronika palanačkog groblja
Tvrdica
Koreni
Jazavac pred sudom
Gospođica
Danga
Seobe
Sve će to narod pozlatiti

*POZIVNI BROJEVI
NIŠ=
VALJEVO=
ŠABAC=
SREMSKA MITROVICA=
LESKOVAC=
ZRENJANIN=
ZAJEČAR=
POŽAREVAC=

022
018
016
023
012
015
019
014

*Glumci
Berček=
Zablaćanski=
Tatić=
Nikolić=
Brajović=
Manojlović=
Žigon=
Kralj=

Dragan
Stevo
Voja
Milenko
Aleksandar
Josif
Petar
Miki

*Spojte pisce sa svojim delima
Ernest Hemingvej=Zbogom oružje
Šarl Bodler=Cveće zla
Alesandro Manconi=
Šarlot Bronte=
Emili Bronte=
Doris Lesing=
Justejin Gorder=
Bernhard Šlink=

Zamak u Pirinejima
Peto dete
Verenici
Vikend
Orkanski Visovi
Džejn Ejr

*Povežite italijanske regije sa njihovim glavnim gradovima:
Veneto=
Umbrija=
Toskana=
Sicilija=
Sardinija=
Kalabrija=
Abruco=
Bazilikata=

Kaljari
Potenca
Katancaro
Palermo
Peruđa
Venecija
L'Akvila
Firenca

*Spojite poznate parove
Zevs=
Dante=
Petrarka=
Laza Kostic=
Paris=
Elizabet Tejlor=
Tristan=
Troil=

Lenka Dunđerski
Kresida
Ricard Barton
Izolda
Hera
Beatrice
Laura
Jelena

*Povežite čuvene vojskovođe sa ratovima u kojim su učestvovali:
Saladin=
Gotfrid Bujonski=
Scipion Afrički=
Hamilkar Barka=
Mihail Kutuzov=
Georgij Žukov=
Robert Li=
Oliver Kromvel=

Treći krstaški rat
Amer. građanski rat
Prvi punski rat
Drugi svetski rat
Napoleonovi ratovi
Drugi punski rat
Prvi krstaški rat
Engl. građanski rat

*Povežite italijanske regije sa njihovim glavnim gradovima:
Apulija=
Kampanija=
Emilija-Romanja=
Lacio=
Ligurija=
Lombardija=
Pijemont=
Toskana=

Bari
Milano
Rim
Đenova
Napulj
Firenca
Bolonja
Torino

*Povežite nemačke države (republike) sa njihovim glavnim gradovima:
Donja Saksonija=
Brandenburg=
Bavarska=
Baden-Virtemberg=
Saksonija=
Šlesvig-Holštajn=
Sarland=
S Rajna-Vesfalija=

Štutgart
Dizeldorf
Kil
Sarbriken
Hanover
Potsdam
Minhen
Dresden

*GLAVNI GRADOVI
AZERBEJDžAN=
AVGANISTAN=
ŠVAJCARSKA=
IRAK=
IRAN=
NORVEŠKA=
ŠVEDSKA=
DANSKA=

STOKHOLM
OSLO
KABUL
KOPENHAGEN
BAGDAD
BERN
TEHERAN
BAKU

*medicina - latinski nazivi organa
srce=
jetra=
želudac=
dušnik=
gušterača=
slezina=
mali mozak=
kičma=

cerebellum
lien
gaster
hepar
columna vertebralis
pancreas
trachea
cor

*Povežite gitariste sa grupama u kojima su nastupali ili još uvek nastupaju:
Petar Jelić=
Husein Hasanefendić=
R. M. Točak=
Dragan Gužvan=
Vlatko Stefanovski=Leb i sol
Nebojša Antonijević=
Rajko Kojić=
Milan Mladenović=

Partibrejkers
EKV
Parni Valjak
YU grupa
Atomsko sklonište
Riblja Čorba
Smak

*Spojite imena muskaraca sa imenima njihovih zena
Car Lazar=
Stefan Nemanja=
Slobodan Milošević=
Vojislav Koštunica=
Aleksandar Obrenovic=
Kralj Petar prvi=
Dragan Nikolić=
Zoran Đinđić=

Anastasija
Milena Dravić
Zorka Petrović
Zorica Radović
Draga Mašin
Mirjana Marković
Ružica Pavlović
Carica Milica

*Povežite gitariste sa grupama u kojima su nastupali ili još uvek nastupaju:
Pete Townshend=
Eric Clapton=
Jimmy Page=
Kirk Hammett=
Jerry Garcia=
John Frusciante=
The Edge=
Mark Knopfler=

U2
R. H. Chili Peppers
Cream
Dire Straits
Metallica
Led Zeppelin
Grateful Dead
The Who

*GLUMICE I FILMOVI
SOBARICA I SENATOR=
DANAS 13 SUTRA 30=
LJUBAVNO GNEZDO=
UPRAVO VENČANI=
PRVI GREH=
PRAVNA PLAVUŠA=
ODBEGLA MLADA=
ĐAVO NOSI PRADU=

Meryl Streep
Julia Roberts
Angelina Jolie
Jennifer Lopez
Drew Barrymore
Jennifer Garner
Brittany Murphy
Reese Witherspoon

*IMENA I PREZIMENA GLUMICA
MIRA=
RUŽICA=
GORICA=
LJILJANA=
RADMILA=
LIDIJA=
SVETLANA=
JELICA=

POPOVIĆ
SOKIĆ
BOJKOVIĆ
SRETENOVIĆ
SAVIĆEVIĆ
VUKIČEVIĆ
BLAGOJEVIĆ
BANJAC

*GRUPE I PESME
GALIJA=
TAP 011=
ZANA=
LUNA=
ĐOGANI=
FUNKY G=
AMADEUS BEND=
OK BEND=

IGRAJ
DOSADAN DAN
KUCICA
LAŽU TE
DA ME NISI
SOBA
BUBICE
ĐAVOLE

*Latinske reči i značenja
lex=
rex=
pax=
nox=
senex=
pons=
bellum=
ius=

noć
mir
kralj
starac
rat
most
pravo
zakon

*Povežite filmske likove sa filmovima u kojim se pojavljuju:
Dr Hanibal Lektor=
Norman Bejts=
Džon Konor=
Lois Lejn=
Toni Montana=
Džek Sperou=
Endi Dufrejn=
Vinsent Vega=

Terminator
Psiho
Bekstvo iz Šošenka
Petparačke priče
Skarfejs
Pirati s Kariba
Supermen
Crveni Zmaj

*RODITELJI I DECA
AFRODITA=
AGRIPINA=
TETIDA=
TANTAL=
FRANC LIST=
KRALJ LIR=
EDIP=
PABLO PIKASO=

ENEJA
ANTIGONA
KOZIMA VAGNER
AHIL
NERON
PALOMA
NIOBA
KORDELIJA

*Povežite književne junake sa piscima koji su ih stvorili:
Edmond Dantes=
Žan Valžan=
Paspartu=
Ajvanho=
Pol Muad'Dib=
Hari Seldon=
Artur Dent=
Le Šifr=

Aleksandar Dima
Daglas Adams
Frenk Herbert
Žil Vern
Viktor Igo
Ijan Fleming
Volter Skot
Isak Asimov

*Povežite književne junake sa piscima koji su ih stvorili:
Tarzan=
Kapetan Ahab=
Filaes Fog=
Doktor Džekil=
Filip Marlou=
Viktor Frankenštajn=
Ema Bovari=
Leopold Blum=

Herman Melvil
Gistav Flober
Meri Šeli
Robert L. Stivenson
Rejmond Čendler
Žil Vern
Džejms Džojs
Edgar Rajs Barouz

*Teniseri
Novak=
Rodzer=
Rafael=
Marat=
Gael=
Igor=
Janko=
Viktor=

Andrejev
Troicki
Federer
Đoković
Monfils
Safin
Tipsarević
Nadal

*Povežite književne junake sa delima iz kojih potiču:
Žilijen Sorel=
Ahmed Nurudin=
Holden Kolfild=
Knez Miškin=
Žan Valžan=
Raskoljnikov=
Ljuba Vrapče=
Andreas Sam=

Kad su cvetale tikve
Zločin i kazna
Derviš i smrt
Rani jadi
Idiot
Lovac u žitu
Jadnici
Crveno i crno

*Allo, Allo
Gorden Kaye=
Carmen Silvera=
Richard Marner=
Guy Siner=
Sue Hodge=
Rose Hill=
Jack Haig=
Vicki Michelle=

Gruber
Lekler
Mimi la Bonk
Edit Artois
Rene Artois
fon Strom
Ivet
Fani

*hitovi i izvođači
Come Undone=
Dancing Queen=
Women in Love=
Careless Whisper=
Hotel California=
Need You Tonight=
Frozen=
Wind of Change=

Eagles
Scorpions
INXS
George Michael
ABBA
Duran Duran
Madonna
Barbra Streisand

*Rođeni prvog aprila
Otto von Bismarck=
Barry Sonnenfeld=
John Quade=
Joseph E. Murray=
Abraham Maslow=
Susan Boyle=
Miodrag Petrović Čkalja=
Mark Jackson=

Glumac, 1924
Pevačica, 1961
Režiser, 1953
Košarkaš, 1965
Lekar, 1919
Glumac, 1938
Psiholog, 1908
Političar, 1815

*Povežite nagrade sa oblastima za koje se dodeljuju:
Diskobolos=
Ranko Radović=
Lazar Komarčić=
Nikola Burzan=
Pavle Vujisić=
Disova nagrada=
Ninova nagrada=
Zlatni osmeh=

fotografija
naučna fantastika
arhitektura
gluma (životno delo)
roman godine
poezija
karikatura
radio i televizija

*Glavni gradovi
Bejrut=
Rabat=
Adis Abeba=
Dzakarta=
Luanda=
Najrobi=
Islamabad=
Manila=

Indonezija
Pakistan
Angola
Maroko
Liban
Etiopija
Filipini
Kenija

*Fudbaleri Srbije
Nikola=
Milos=
Sasa=
Milan=
Vlada=
Zoran=
Bane=
Nemanja=

Jovanović
Ivanović
Avramov
Krasić
Žigić
Ilić
Vidić
Tošić

*Automobili i proizvođači
Tiguan=
Koleos=
Fusion=
Santa Fe=
Antara=
Linea=
Sorento=
Note=

Renault
KIA
Fiat
Hyundai
Opel
Ford
Nissan
Volkswagen

*Simboli hemijskih elelenata
Kiseonik=
Magnezijum=
Bor=
Hrom=
Cink=
Fluor=
Helijum=
Arsen=

F
As
Mg
O
Zn
Cr
He
B

*Rok pesme i grupe
Ratne igre=
Kapetan Esid=
Krug=
Ruski voz=
Zenica bluz=
Kada padne noć=
Čudna šuma=
Kada sanjamo=

YU grupa
Riblja čorba
Električni orgazam
Piloti
Bajaga i Instruktori
EKV
Zabranjeno pušenje
Kerber

*Ministri u vladi Srbije (2009)
Dijana Dragutinović=
Snežana Malović=
Božidar Đelić=
Verica Kalanović=
Petar Škundrić=
Jasna Matić=
Svetozar Čiplić=
Rasim Ljajić=

Pravda
Ljudska i manj. prav
Telekomunikacije
Nac. Investic. plan
Rudarstvo i energet.
Nauka i tehn. razvoj
Rad i soc. politika
Finansije

*Kompozitori
Štraus=Rihard
Mendelson=Feliks
Bartok=Bela
Britn=Bendžamin
Leonkavalo=Rudžero
Doniceti=Gaetano	
Šubert=Franc
Vivaldi=Antonio

*Spojite gitariste sa njihovim bendovima
Deep Purple=Richi Blackmoor
Led Zeppelin=Jimmy Page
Black Sabbath=Tony Lommi
Nirvana=Kurt Cobain
Azra=Branimir Štulić
AC/DC=Angus Jang
EKV=Milan Mladenović
Riblja Čorba=Vidoja Bozinović

*Letnje olimpijske igre
Sidnej=
Rim=
Helsinki=
Tokio=
Moskva=
Antverpen=
Meksiko Siti=
Melburn=

1920
2000
1956
1980
1960
1964
1968
1952

*Gradovi i države u SAD-u
Denver=Kolorado
Sakramento=Kalifornija
Finiks=Arizona
Ostin=Teksas
Nešvil=Tenesi
Santa Fe=Novi Meksiko
Boston=Masačusets
Solt Lejk Siti=Juta

*Spojite imena i prezimena muzičara
Fats=
Dizzy=
Benny=
Buck=
John=
Miles=
Chick=
Charles=

Davis
Mingus
Gillespie
Domino
Coltrane
Clayton
Corea
Goodman

*Spojte 8 najvećih država na svetu sa njihovim površinama (km2):
17.075.200=Rusija
9.976.140=Kanada
9.639.810=SAD
9.598.077=Kina
8.511.965=Brazil
7.687.453=Australija
3.287.590=Indija
2.766.890=Argentina

*Glavni gradovi
Riga=Letonija
Talin=Estonija
Tbilisi=Gruzija
Dablin=Irska
Nikozija=Kipar
Minsk=Belorusija
Kijev=Ukrajina
Beograd=Srbija

*Legende FK Partizan
Momčilo=
Stjepan=
Vladica=
Velibor=
Dragan=
Radomir=
Saša=
Milko=

Vukotić
Ilić
Mance
Kovačević
Bobek
Djurovski
Vasović
Antić

*Spojte generalne sekretare UN sa godinama u kojima su obavljali tu dužnost:
1946-1952=
1953-1961=
1961-1971=
1972-1981=
1982-1991=
1992-1996=
1997-2006=
od 2007=

Butros Butros-Gali
Trigve Li
Ban Ki-Mun
Perez de Kueljar
Dag Hameršeld
Kurt Valdhajm
Kofi Anan
U Tant

*Spojte Danteove krugove pakla sa osobinama onih koji u njima borave:
1.=
2.=
3.=
4.=
5.=
6.=
8.=
9.=

Jeretici
Izdajnici
Pohotni
Limbo (nekršteni)
Gnevni i srditi
Lakomi
Lažljivci
Proždrljivi

*mladi i stari
tele=
jare=
jagnje=
prase=
ždrebe=
mače=
pile=
pače=

kobila
patka
mačka
svinja
koza
krava
kokoška
ovca

*Povežite stilove u umetnosti sa vremenskim periodima u kojima su vladali:
Gotika=
Renesansa=
Barok=
Rokoko=
Neoklasicizam=
Romantizam=
Postimpresionizam=
Fovizam=

18. vek
12 - 16. vek
1750 - 1850.
1780 - 1850.
1900 - 1908.
17. vek
1880 - 1910.
14 - 16. vek

*Države i valute
Brazil=
Lihtenštajn=
Meksiko=
Novi Zeland=
Pakistan=
San Marino=
Tunis=
Kina=

evro
real
juan
rupija
franak
dolar
dinar
pezos

*POVEZATI KLUBOVE SA GRADOM
Barselona=
Real Madrid=
Partizani=
PKB=
Chelsea=
Manchester United=
Partizan=
Inter=

Barselona
Beograd
Padinska Skela
Mančester
London
Tirana
Madrid
Milan

*Poređajte minerale po Mosovoj skali tvrdoće (broj 1 je najmekši):
1=
2=
3=
5=
7=
8=
9=
10=

talk
korund
kvarc
kalcit
gips
dijamant
apatit
topaz

*Države i valute
Albanija=
Australija=
Belorusija=
Bugarska=
Egipat=
Indija=
Norveška=
Turska=

lek
kruna
funta
rublja
dolar
lira
lev
rupija

*Povežite španske fudbalske klubove i gradove
Osasuna=
Selta=
Deportivo=
Hetafe=
Espanjol=
Betis=
Rasing=
Rekreativo=

Uelva
Santander
Barselona
Pamplona
La Korunja
Vigo
Madrid
Sevilja

*Nemački pisci i njihova dela
Hajnrih Bel=
Fridrih Šiler=
Zigfrid Lenc=
Tomas Man=
Erih Maria Remark=
Hajnrih Man=
Martin Valser=
Ginter Gras=

Gde si bio Adame
Rad na duši
Čarobni breg
Profesor Unrat
Iskra života
Srpska devojka
Razbojnici
Lokalna anestezija

*Glavni gradovi
Kamerun=
Burundi=
Uganda=
Mauritanija=
Niger=
Čad=
Burkina Faso=
Zambija=

Uagadugu
Ndžamena
Budžumbura
Lusaka
Nuakšot
Kampala
Nijamej
Jaunde

*Povežite američke predsednike sa novčanicama na kojima se nalaze njihovi likovi:
Džordž Vašington=
Tomas Džeferson=
Abraham Linkoln=
Aleksander Hamilton=
Endru Džekson=
Julisiz Grant=
Bendžamin Franklin=
Grover Klivlend=

10$
100$
20$
2$
1$
5$
1000$
50$

*Pesnici i njihove zbirke pesama
Šarl Bodler=
Artur Rembo=
Volt Vitmen=
Huan Ramon Himenez=
Pablo Neruda=
Gijom Apoliner=
T.S. Eliot=
Stefan Malarme=

Ja nisam ja
Vlati trave
Pijani brod
Sunce u repu vetra
4 kvarteta
Alkoholi
Popodne jednog fauna
Cveće zla

*Svetska prvenstva u fudbalu
Francuska=
Švajcarska=
Nemačka=
Urugvaj=
Meksiko=
Čile=
Engleska=
Argentina=

1962.
1954.
1974.
1966.
1998.
1978.
1930.
1986.

*Gradovi i reke na kojima se nalaze
Lion=
Nant=
Krakov=
Grac=
Linc=
Senta=
Šabac=
Poznanj=

Varta
Sava
Dunav
Rona
Visla
Loara
Mura
Tisa

*Povežite reči sa nastavkom -cid sa njihovim nazivima:
paricid=ubistvo rođaka
regicid=ubistvo kralja
vaticid=ubistvo proroka
uksoricid=ubistvo supruge
sororicid=ubistvo sestre
fratricid=ubistvo brata
suicid=ubistvo samog sebe
homicid=ubistvo osobe
senicid=ubistvo starog lica
matricid=ubistvo majke
mariticid=ubijanje muža
patricid=ubistvo oca
formicid=supstanca za ubijanje mrava
herbicid=supstanca za ubijanje biljaka
fungicid=supstanca za ubijanje gljiva
rodenticid=supstanca za ubijanje glodara
pulicid=supstanca za ubijanje buva
pesticid=supstanca za ubijanje štetočina
muskicid=supstanca za ubijanje muva
insekticid=supstanca za ubijanje insekata
vermicid=supstanca za ubijanje crvova
aficid=sredstvo za ubijanje vaši
vespacid=supstanca za ubijanje osa
#http://sr.wikipedia.org/sr-el/%D0%A1%D0%BF%D0%B8%D1%81%D0%B0%D0%BA_%D1%80%D0%B5%D1%87%D0%B8_%D1%81%D0%B0_%D0%BD%D0%B0%D1%81%D1%82%D0%B0%D0%B2%D0%BA%D0%BE%D0%BC_-%D1%86%D0%B8%D0%B4

*Grupe i nazivi njihovih albuma ?
The Beach Boys=
John Coltrane=
Beatles=
The Byrds=
Bob Dylan=
The Who=
The Kinks=
The Mamas & the Papas=

Highway 61 Revisited
If You Can Believe Y
Sings My Generations
Mr Tambourine Man
A Love Supreme
Today!
Face To Face
Rubber Soul 

*Fudbalski klubovi i gradovi iz kojih potiču ?
Aston Vila=
Everton=
Juventus=
Levante=
Espanjol=
Totenhem=
Sparta=
Rapid=

Beč
Roterdam
Barselona
Birmingem
Torino
Liverpul
Valensija
London

*Gradovi i reke na kojima se nalaze
Firenca=
Vroclav=
Drezden=
Keln=
Verona=
Tbilisi=
Erevan=
Nirnberg=

Adiđe
Pegniz
Kura
Rajna
Odra
Arno
Razdan
Elba

*Formule kiselina
Mravlja=
Sircetna=
Limunska=
Sumporasta=
Sumporna=
Sona=
Fosforna=
Fosforasta=

H Cl
C2 H4 O2
C6 H8 O7
H3 P O4
C H2 O2
H3 P O3
H2 S O3
H2 S O4

*Grčkom Bogu odgovara rimski Bog
Hermes=
Ares=
Eos=
Hefest=
Enio=
Artemida=
Afrodita=
Had =

Venera
Dijana
Mars
Pluton
Vulkan
Aurora
Belona
Merkur

*Prozvođači i tipovi automobila A segmenta
Suzuki=Swift
Tata=Nano
Toyota=IQ
Mini=Cooper
Fiat=500
VW=Lupo
Citroen=C1
Nissan=Micra

*Spojite rok zvezde sa godinama koje su doživeli:
Marvin Gej=
Mark Bolan=
Kurt Kobejn=
Džon Lenon=
Riči Valens=
Sid Višiz=
Badi Holi=
Soni Bono=

40
62
21
22
44
29
27
17

*Pesnici i njihove pesme
Vladislav Petković D=
Miloš Crnjanski=
Desanka Maksimović=
Vojislav Ilić=
Oskar Davičo=
Stevan Raičković=
Vasa Živković=
Matija Bećković=

Gospođici N
Graničarska pesma
Hana
Vojnička pesma
Možda spava
Na buri
Vera Pavladoljska
Tisa

*Pesnici i njihove pesme
Đura Jakšić=
Miloš Crnjanski=
Rade Drainac=
Stevan Raičković=
Branislav Petrović=
Momčilo Nastasijević=
Branko Radičević=
Laza Kostić=

Kamena uspavanka
Jadna draga
Gradilište
Mizera
Otadžbina
Mesto testamenta
Spomen na Ruvarca
Jedinoj

*U kojoj državi je grad
Herat=
Čitagong=
Isfahan=
Haifa=
Irbid=
Taškent=
Hajfong=
Damask=

Uzbekistan
Avganistan
Sirija
Jordan
Bangladeš
Izrael
Vijetnam
Iran

*Pisci i dela
Janko Veselinović=
Milovan Glišić=
Vladan Desnica=
Arsen Diklić=
Anto Stančić=
Branislav Nušić=
Branko Ćopić=
Dositej Obradović=

Hajduci
Život i priključenij
Prva brazda
Hajduk Stanko
Mali pirat
Salaš u Malom ritu
Doživljaji mačka Toše
Proljeće Ivana Galeb

*U kojoj državi je grad
Luena=
Fajum=
Mombasa=
Sus=
Kigali=
Aksum=
Oran=
Timbuktu=

Angola
Etiopija
Tunis
Ruanda
Egipat
Mali
Kenija
Alžir

*U kojoj državi je jezero
Venern=
Tana=
Iljmenj=
Urmija=
Balaton=
Čarvak=
Van=
Kinghaj=

Mađarska
Kina
Uzbekistan
Iran
Etiopija
Švedska
Turska
Rusija

*Kojoj državi pripada ostrvo
Rigen=
Uskršnje ostrvo=
Maražo=
Kurasao=
Elzmir=
Svalbard=
Zmijsko ostrvo=
Palavan=

Kanada
Filipini
Norveška
Holandija
Čile
Nemačka
Ukrajina
Brazil

*Kojoj državi pripada ostrvo
Galapagos=
Bornholm=
Devon=
Mindanao=
Kokosova ostrva=
Gotland=
Halmahera=
Sokotra=

Filipini
Jemen
Švedska
Indonezija
Ekvador
Danska
Kanada
Australija

*Pisci i njihova dela
Dragan Velikić=
David Albahari=
Ivo Andrić=
Mladen Markov=
Aleksandar Vučo=
Miro Vuksanović=
Vladan Desnica=
Dobrica Ćosić=

Koreni
Olupine na suncu
Mrtve javke
Ruski prozor
Gospođica
Mamac
Ukop oca
Semolj zemlja

*Nobelovci i godina dobijanja nagrade
Sili Pridom=
Herta Miler=
Ernest Hemingvej=
Ivo Andrić=
Dario Fo=
Rabindranat Tagore=
Herman Hese=
Hajnrih Bel=

1913
1972
2009
1901
1997
1961
1946
1954

*Spojite drzave sa glavnim gradovima..!
Francuska=
Nemačka=
Filipini=
Maroko=
Češka=
Malta=
Grčka=
Slovenija=

Pariz
Atina
Rabat
La Valeta
Prag
Manila
Berlin
Ljubljana

*Pisci i njihova dela
Danilo Nikolić=
Zoran Ćirić=
Miloš Crnjanski=
Oskar Davičo=
Svetozar Vlajković=
Živojin Pavlović=
Vidosav Stevanović=
Meša Selimović=

Beton i svici
Testament
Vera
Hobo
Fajront u Grgetegu
Kod Hiperborejaca
Tišine
Lapot

*Povežite strahove sa njihovim nazivima:
od paukova=
od stranaca=
od broja 13=
od venčanja=
od ljubljenja=
od pakla=
od ismevanja=
od golog tela=

arahnofobija
stigiofobija
gamofobija
filematofobija
ksenofobija
gimnofobija
triskaidekafobija
katagelofobija

*Engleski pisci i njihova dela
Virdžinija Vulf=
Čarls Dikens=
Grejem Grin=
Vilijam Golding=
Danijel Defo=
Oldus Haksli=
Džozef Konrad=
Radjard Kipling=

Kim
Lord Džim
Mol Flanders
Gospođa Delovej
Ljudski faktor
Velika očekivanja
Zvonik
Kontrapunkt života

*Poznati frontmeni grupa
Bono=
Mik Džeger=
Robert Plant=
Kris Martin=
Dejvid Koverdejl=
Bon Skot=
Džejms Hetfild=
Stiven Tajler=

AC/DC
U2
Aerosmith
Whitesnake
Rolling Stones
Coldplay
Metallica
Led Zeppelin

*Francuski pisci i njihova dela
Alber Kami=
Žan Pol Sartr=
Andre Breton=
Prosper Merime=
Gistav Flober=
Emil Zola=
Marsel Prust=
Volter=

Karmen
Kandid
Jazbina
Zatočenica
Pad
Zid
Nadja
Salambo

*Vrste pogona
Avion=
Voz=
Automobil=
Jedrenjak=
Bicikl=
Balon=
Tramvaj=
Podmornica=

Benzin
Vodena para
Električna energija
Nuklearna energija
Noge
Vodonik
Vetar
Kerozin

*Povežite strahove sa njihovim nazivima:
od stranih jezika=
od vodozemaca=
od brade=
od zaraznosti=
od krađe=
od dodirivanja=
od boja=
od vetrova=

harpagofobija
aurofobija
afenfosmofobija
tapinofobija
batrahofobija
ksenoglosofobija
hromatofobija
pogonofobija

*Američki pisci i njihova dela
Sol Belou=
Ernest Hemingvej=
Skot Ficdžerald=
Vilijam Fokner=
Herman Melvil=
Vilijam Stajron=
Džon Stajnbek=
Džon Dos Pasos=

Sofijin izbor
Menhetn transfer
Pokretni praznik
Hercog
Mobi Dik
Buka i bes
Istočno od raja
Blaga je noć

*Italijanski pisci i njihova dela
Luiđi Pirandelo=
Alberto Moravija=
Italo Zvevo=
Dino Bucati=
Euđenio Montale=
Gracija Deleda=
Čezare Paveze=
Đovani Verga=

Rimljanka
Đavo na brežuljku
Starac s planine
Tatarska pustinja
Sipina kost
Zenova svest
Porodica Malavolja
Pazi, snima se...

*Povežite sisteme vladavine sa njihovim nazivima:
sirotinje=
bogatih=
muškaraca=
žena=
svetaca=
biskupa=
klerika=
najgorih mogućih=

eklezijarhija
egzarhija
andokratija
plutokratija
kakistokratija
hagiarhija
ginarhija
ptokratija

*Pseudonimi
Tom Džouns=
Toni Montano=
Vajat Erp=
Vanila Ajs=
Vudi Alen=
Toto=
Teodor Filipović=
Toni Kertis=

Tomas Vudvord
Antonio Galjardi
Robert Van Vinkl
Alen Stjuart Kenigsberg
Velibor Miljković
Bernard Švarc
Beri Step
Božidar Grujović

*Ratovi i godine
Banatski ustanak=
Košćuškov ustanak=
Rat kralja Filipa=
Kandijski rat=
Livonski rat=
Prvi rusko-turski=
Za nezavisnost SAD=
Severni 7-godišnji=

1768. - 1774.
1594.
1563. - 1570.
1558. - 1583.
1794.
1645. - 1669.
1775. - 1783.
1675. - 1676.

*Pronalazači
Šibice=
Teleskop=
Baterija=
Gajgerov brojač=
Crna kutija=
Holograf=
Otvarač za konzerve=
Bar kod=

Hans Gajger
Alesandro Volta
Galileo Galilej
Dejvid Voren
Ezra Vorner
Denis Gabor
Džozef Vudlend
Džon Voker

*Režiseri i filmovi
Robert Altman=
Piter Džekson=
Dejvid Linč=
Piter Vir=
Stiven Doldri=
Majkl Men=
Ridli Skot=
Stiven Soderberg=

Trumanov šou
Malholand Drajv
Gospodar prstenova
Bili Eliot
Gladijator
Insajder
Erin Brokovič
Gosford Park

*Poznate žene
Agata Kristi=
Marija Kiri=
Marija Kalas=
Alisa Marić=
Olja Ivanjicki=
Borka Vučić=
Mira Banjac=
Adriana Lima=

Bankarstvo
Fizika
Opersko pevanje
Gluma
Književnost
Manekenstvo
Šah
Slikanje

*Pseudonimi
Raspućin=
Ričard Barton=
Roki Marćano=
Rudolf Valentino=
Sting=
Stivi Vonder=
Tintoreto=
Tom Kruz=

Jakopo Robusti
Stivlend Moris Džadkins
Roko Frensis Markeđano
Ričard Dženkins
Tomas Mapoter
Gordon Samner
Rudolfo Guljelmi
Grigorij Jefimovič

*Izumitelji
Mitraljez=
Jo-jo=
Seizmograf=
Kombajn=
Giljotina=
Pneumatske gume=
Trioda=
Štamparija=

Džon Danlop
Johan Gutenberg
Donald Dankan
Ričard Gatling
Žozef Giljoten
Džon Dir
Li Deforest
Boris Golicin

*Kolonije
Kamerun=
Australija=
Alžir=
Kuba=
Angola=
Libija=
Surinam=
Kongo=

Portugalija
Belgija
Italija
Španija
Engleska
Nemačka
Holandija
Francuska

*Ostrva
Ognjena=
Velika=
Dugi=
Mali=
Nova=
Novi=
Sveti=
Američka=

Zeland
Britanija
Otok
Vincent i Grenadini
Zemlja
Samoa
Lošinj
Gvineja

*Režiseri i filmovi
Džoel Koen=
Kris Nunan=
Majkl Radford=
Tim Robins=
Kventin Tarantino=
Robert Altman=
Mel Gibson=
Stiven Spilberg=

Kratki rezovi
Bejb
Poštar
Hrabro srce
Fargo
Šindlerova lista
Mrtav čovek hoda
Petparačke priče

*Narodi i oblast gde žive
Kašubi=
Moravci=
Tati=
Tajmani=
Muhadžiri=
Aromuni=
Katalonci=
Kabili=

Avganistan
Španija
Pakistan
Češka
Poljska
Iran
Alžir
Grčka

*Pronalazači
Flaster=
Frižider=
Podmornica=
Erkondišn=
Integralno kolo=
Gramofon=
Klavir=
Mikroskop=

Erl Dikson
Tomas Edison
Vilis Kerijer
Džek Kilbi
Vilijam Kalen
Zaharijus Jansen
Kornelijus Drebel
Bartolomeo Kristofori

*Pseudonimi
Mark Tven=
Nikolas Kejdž=
Omar Šarif=
Oskar Vajld=
Pablo Pikaso=
Pančo Vilja=
Pele=
Prins=

Francisko Doroteo Arango
Nikolas Kim Kopola
Mihael Šalhoub
Edson Arantes do Nasimento
Semjuel Lenghorn
Rodžer Nelson
Fingal O'Flaerti Vilis
Blasko Pablo Ruz

*Kompanije
Telenor=
Boing=
Kola-kola=
Intel=
Kraft Foods=
Majkrosoft=
Lukoil=
BMW=

Poluprovodnici
Pića
Avioni
Hrana
Prerada nafte
Softver
Automobili
Telekomunikacije

*Ratovi i godine
Prvi svetski rat=
Mađarska revolucija=
Ruski građanski=
Drugi svetski rat=
Korejski rat=
Grčko-turski rat=
Tangerska kriza=
Španski građanski=

1923. 
1920. - 1922.
1918. - 1922.
1919.
1936. - 1939.
1950. - 1953.
1939. - 1945.
1914. - 1918.

*Režiseri i filmovi
Sofija Kopola=
Klint Istvud=
Fernando Meireles=
Piter Vir=
Pedro Almodovar=
Stiven Doldri=
Rob Maršal=
Martin Skorseze=

Gospodar i ratnik
Čikago
Pričaj sa njom
Mistična reka
Izgubljeni u prevodu
Božji grad
Bande Njujorka
Sati

*Pronalazači
Mobilni telefon=
Stetoskop=
Revolver=
Antiseptik=
Lego kocke=
Polariod=
Semafor=
Detektor laži=

Ole Kristijansen
Džon Larsen
Edvin Land
Džozef Lister
Rene Lenek
Martin Kuper
Garet Morgan
Semjuel Kolt

*Festivali
Dani ludaje=
EXIT=
Čvarkijada=
Gitarijada=
Zlatni kotlić=
FEST=
Kobasicijada=
Dragačevski sabor=

Kikinda
Beograd
Zaječar
Stari Slankamen
Novi Sad
Guča
Valjevo
Turija

*Stari narodi
Aboridžini=
Južna Amerika=
Severna Amerika=
Afrika=
Bliski istok=
Daleki istok=
Italija=
Skandinavija=

Mongoli
Vikinzi
Inke
Australija
Feničani
Kartaginjani
Etrurci
Apači

*Pseudonimi
Kirk Daglas=
Lorens od Arabije=
Luis Kerol=
Maksim Gorki=
Mahatma Gandi=
Muhamed Ali=
Molijer=
Martin Šin=

Tomas Edvards Lorens
Žan-Batist Poklen
Kasijus Klej
Aleksej Pješkov
Mohandas Karamčand
Čarls Latvidz Dodzson
Ramon Estevez
Išur Danijelovič Demski

*Izumitelji
Odbojka=
Košarka=
Barometar=
Logaritam=
Kola-kola=
Dinamit=
Vespa=
Celuloid=

Alfred Nobel
Džejms Nejsmit
Blez Paskal
Enriko Pjađo
Vilijem Morgan
Aleksandar Palks
Džon Neper
Džon Pemberton

*Ratovi i godine
Iračko-iranski rat=
Zaliv svinja=
Kubanska kriza=
Suecka kriza=
Praško proleće=
Vijetnamski rat=
Libanski građanski rat=
Kineski građanski=

1959. - 1975.
1961.
1962.
1975. - 1990.
1980. - 1988.
1927. - 1950.
1956.
1968

*Režiseri i filmovi
Džordž Kluni=
Edrijen Lajn=
Benet Miler=
Stiven Spilberg=
Tejlor Hekford=
Majk Li=
Aleksander Pejn=
Martin Skorseze=

Minhen
Avijatičar
Vira Drejk
Stranputice
Laku noć i srećno
Fatalna privlačnost
Kapoti
Rej

*Pseudonimi
Hari Hudini=
Henri Kisindžer=
Igi Pop=
Iv Montan=
Iv Sen-Loren=
Johan Gutenberg=
Jul Briner=
Karim Abdul Džabar=

Erik Vajs
Taiđe Kan
Anri Dona Matje
Džejms Njuel
Hajnc Alfred
Ferdinand Luis Elsindor
Ivo Livi
Johanes Gensflajš

*Bića iz slovenske mitologije
Baga Jaga=
Balačko=
Vampir=
Vesna=
Vukodlak=
Karakondžula=
Morana=
Perun=

Oživeli leš
Troglavi div
Boginja smrti
Bog neba i groma
Polu čovek polu vuk
Noćni demon
Boginja proleća
Veštica

*Izumitelji
Radio antena=
Kompakt disk=
Avion=
Saharin=
Mikrotalasna peć=
Helikopter=
Saksofon=
Čaj u kesici=

Braća Rajt
Džejms Rasel
Adolf Saks
Tomas Saliven
Persi L. Spenser
Igor Sikorski
Ajra Remzen
Aleksandar Popov

*Sazvežđa i zvezde
Mali medved=
Blizanci=
Veliki pas=
Orao=
Lira=
Lav=
Orion=
Škorpija=

Altair
Sirijus
Kastor
Vega
Betelgez
Regulus
Antares
Severnjača

*Pseudonimi
Eminem=
Erik Klepton=
Filip Cepter=
50 cent=
Fredi Merkjuri=
Gari Kasparov=
Garinča=
Gručo Marks=

Maršal Brus Meders III
Manuel Francisko dos Santos
Faruk Bulsara
Milan Janković
Erik Patrik Klep
Džulijus Henri Marks
Kurtis Džekson
Gari Vajnštajn

*Ratovi i godine
Timočka buna=
Srpsko-bugarski rat=
Rifski rat=
Ilindenski ustanak=
Drugi balkanski rat=
Prvi balkanski rat=
Drugi srpsko-turski=
Prvi srpsko-turski=

1913.
1876. - 1877.
1912. - 1913.
1903.
1885.
1883.
1877. - 1878.
1893.

*Ljudi i zanimanja
Stefan Milenković=
Ruđer Bošković=
Petar Drapšin=
Đorđe Vajfert=
Željko Rebrača=
Đorđe Balašević=
Petar Kočić=
Milan Konjović=

General
Astronom
Pisac
Slikar
Košarkaš
Muzičar
Industrijalac
Violinista

*Pronalazači
Indukciona mašina=
Penicilin=
Elektronska pošta=
Nuklerarni reaktor=
Gromobran=
Žiroskop=
Traktor=
Radio talasi=

Hajnrih Herc
Bendžamin Holt
Bendžamin Franklin
Nikola Tesla
Rej Tomlinson
Aleksandar Fleming
Enriko Fermi
Leon Fuko

*Pseudonimi
Džejms Din=
Džek London=
Džeri Luis=
Džimi Hendriks=
Džon Vejn=
Džordz Majkl=
Džordž Orvel=
Elton Džon=

Džejms Bajron
Erik Artur Bler
Merion Majkl Morison
Džozef Levič
Džon Grifit
Redžinald Kenet Dvajt
Džoni Alen Hendriks
Jorgos Kirijakos

*Režiseri i filmovi
Džoel i Itan Koen=
Pol Tomas Anderson=
Toni Gilroj=
Džejson Rajtman=
Martin Skorseze=
Deni Bojl=
Gas Van San=
Stiven Doldri=

Milk
Milioner sa ulice
Majkl Klejton
Biće krvi
Čitač
Dvostruka igra
Džuno
Nema zemlje za starce

*Pronalazači
Gramofon=
Brajeva azbuka=
Pepsi kola=
Padobran=
Taksimetar=
Ukrštenica=
Parna mašina=
Olovka=

Žan Pjer Blanšar
Laslo Biro
Artur Vajni
Džejms Vat
Emil Berliner
Luj Braj
Kaleb Bredham
Vilhelm Brun

*Ratovi i godine
Napoleonski ratovi=
Prvi srpski ustanak=
Ratovi ruža=
Mašićka buna=
Đakova buna=
Krimski rat=
Prvi opijumski rat=
Američki građanski=

1809.
1802. - 1815.
1825.
1853. - 1856.
1861. - 1865.
1455. - 1485.
1839. - 1842.
1804. - 1813.

*Slikari i slike
Vinsent Van Gog=
Pablo Pikaso=
Salvador Dali=
Fransisko de Goja=
Leonardo da Vinči=
Mikelanđelo=
Klod Mone=
Rembrant=

Obučena maja
Suncokreti
Mona Liza
Stvaranje Adama
Noćna straža
Istrajnost sećanja
Ruanska katedrala
Žena sa gitarom

*Pseudonimi
Čak Noris=
Čarls Bronson=
Čarlton Heston=
Dejvid Boui=
Dejvid Koperfild=
Deni de Vito=
Din Martin=
Dr. Alban=

Danijel Mihaeli
Alban Njapa
Čarls Bučinski
Karlos Rej
Dejvid Kotkin
Dejvid Robert Džouns
Dino Kročeti
Čarls Karter

*Nagrade
Zlatni Hipokrat=
Beli anđeo=
Zlatni osmeh=
Zlatni ćuran=
Zoranov brk=
Zlatna struna=
Kočićeva knjiga=
Oskar prestiža=

Medicina
Poezija
Životno delo i najbolji glumac
Najbolji glumac
Turizam
Auto-privreda
Karikatura
Književnost

*Ljudi i zanimanja
Svetislav Basara=
Laza Kostić=
Nikola Milošević=
Paja Jovanović=
Milan Antonović=
Bora Todorović=
Slobodan Šijan=
Stevan Mokranjac=

Režiser
Glumac
Pesnik
Kompozitor
Slikar
Filozof
Arhitekta
Pisac

*Režiseri i filmovi 2008. godine
Mračni vitez=
Kung-fu panda=
Henkok=
Ajron men=
Mama mia=
Zrno utehe=
Voli=
Seks i grad=

Endru Stenton
Mark Foster
Mark Ozborn
Majkl P. King
Džon Fevro
Piter Berg
Filinda Lojd
Kristofer Nolan

*Izumitelji
Četkica za zube=
Daljinski upravljač=
Stereo zvuk=
Insulin=
Globus=
Tranzistor=
Faks mašina=
Brisači za automobil=

Frederik Banting
Alan Blumlajn
Robert Adler
Martin Behajm
Aleksandar Bejn
Džon Bardin
Meri Anderson
Vilijam Adis

*Pseudonimi
Madona=
Merilin Monro=
Natali Vud=
Nina Simone=
Rita Hejvort=
Silvana Armenulić=
Tina Turner=
Vupi Goldberg=

Junis Vejmon
Karin Džonson
Zilha Barjaktarević
Ana Mej Bulok
Veronika Lujza Čikone
Norma Džin
Nataša Gurdin
Margarita Kansino

*Ratovi i godine
Foklandski rat=
Plišana revolucija=
Američka okupacija Iraka=
Prvi čečenski rat=
Rat u Južnoj Osetiji=
Prvi rat u Kongu=
Drugi zalivski rat=
Sovjetsko-avganistanski=

1994. - 1996.
2003.
1989. - 1990.
2008.
1990. - 1991.
1996. - 1997.
1979. - 1989.
1982.

*Slikari i slike
Đura Jakšić=
Nikola Aleksić=
Miloš Tenković=
Đorđe Krstić=
Marko Murat=
Petar Lubarda=
Uroš Predić=
Paja Jovanović=

Kosovka devojka
Zaklano jagnje
Prodavačica cveća
Portret sinova
Seoba Srba
Dah dubrovačkog proleća
Utopljenica
Devojka u plavom

*Ratovi i godine
Trojanski rat=
Prvi krstaški rat=
Peloponeski rat=
Drugi krstaški rat=
Prvi punski rat=
Stogodišnji rat=
Iberijski rat=
Spartakov ustanak=

1147. - 1149.
526. - 532.
264.p.n.e. - 241.p.n.e.
1096. - 1099.
1194.p.n.e. - 1184.p.n.e.
431.p.n.e. - 404.p.n.e.
73.p.n.e. - 71.p.n.e.
1337. - 1453.

*Režiseri
Ko to tamo peva=
Sabirni centar=
Bure baruta=
Jagode u grlu=
Dom za vešanje=
Mrtav Ladan=
Sedam i po=
Mi nismo anđeli=

Emir Kusturica
Srđan Dragojević
Milorad Milinković
Srđan Karanović
Goran Marković
Slobodan Šijan
Miroslav Momčilović
Goran Paskaljević

*Pseudonimi
Greta Garbo=
Ita Rina=
Karmen Elektra=
Majka Tereza=
MirJam=
Marija Kalas=
Mata Hari=
Marlen Ditrih=

Agneza Gondža Bojadžiju
Tara Patrik
Ida Kravanja
Milica Jakovljević
Margarita Gertruda Zele
Marija Kalogeropulos
Marija Magdalena fon Loš
Greta Gustafson

*Gde se šta nalazi?
Spavaća soba=
Kuhinja=
Kupatilo=
Ulica=
Dvorište=
Garaža=
Tavan=
Podrum=

Kiosk
Ugalj
Automobil
Šunka
Krevet
Frižider
Bojler
Bazen

*Likovi iz stripova
Talični Tom=
Garfild=
Hogar Strašni=
Supermen=
Klodovik=
Mandrak=
Miki Maus=
Snupi=

Kauboj
Mađioničar
Vanzemaljac
Papagaj
Mačak
Pas
Viking
Miš

*Fudbalski reprezentativci
Vladimir=
Nemanja=
Branislav=
Nikola=
Neven=
Nenad=
Gojko=
Dejan=

Milijaš
Stanković
Vidić
Stojković
Subotić
Žigić
Kačar
Ivanović

*Nordijski bogovi
Tor=
Aegir=
Loki=
Odin=
Freja=
Hel=
Saga=
Eli=

Gromovi
Priče i istorija
Mudrost
Podzemni svet
Ljubav
Varanje i podvala
More
Starosti

*Pseudonimi
Ana Bekuta=
Bebi Dol=
Brižit Bardo=
Emili Bronte=
Dajana Kiton=
Džodi Foster=
Édit Pjaf=
Ekstra Nena=

Kamil Žaval
Dragana Šarić
Đovana Gasjon
Snežana Berić
Dajana Hol
Ališa Kristijan Foster
Alis Bel
Nada Polić

*Tandemi iz stripova
Betmen=
Asteriks=
Alan Ford=
Iznogud=
Zagor=
Mirko=
Mandrak=
Mister No=

Robin
Lotar
Dil-el-tant
Slavko
Čiko
Bob Rok
Obeliks
Oto Kruger

*Vaterpolisti
Vladimir=
Aleksandar=
Petar=
Veljko=
Nikola=
Dejan=
Danilo=
Viktor=

Ikodinović
Savić
Šoštar
Jelenić
Uskoković
Trbojević
Kuljača
Vujasinović

*Pseudonimi
Alis Kuper=
Albert Bruks=
Bob Dilan=
Bob Marli=
Bono Voks=
Branislav Nušić=
Brus Li=
Brus Vilis=

Li Juan Kam
Alkibijad Nuša
Robert Alan Cimerman
Albert Ajnštajn
Volter Vilis
Pol Dejvid Hjuson
Robert Nesta
Vinsent Dejmon Furnije

*Telefonski brojevi država
Kanada i SAD=
Španija=
Mađarska=
Grčka=
Egipat=
Nemačka=
Rusija=
Srbija=

30
36
34
20
7
49
381
1

*Fudbalski selektori
Slobodan=
Milan=
Vujadin=
Ilija=
Milovan=
Havijer=
Miroslav=
Radomir=

Petković
Đukić
Đorić
Živadinović
Santrač
Boškov
Antić
Klemente

*Srednjevekovna oružja
Katana=
Trebuše=
Buzdovan=
Tomahavk=
Musketa=
Trirema=
Verižnjača=
Grčka vatra=

Sekira
Mač
Vatreno oružje
Ratni brod
Hemijsko oružje
Topuz
Oklop
Opsadna sprava

*Operski pevači i pevačice
Dragana Jugović=
Marija Kalas=
Sumi Džo=
Lučano Pavaroti=
Nikolaj Đaurov=
Hoze Kareras=
Pavle Holodkov=
Ludvig Veber=

Austrija
Rusija
Bugarska
Srbija
Južna Koreja
Grčka (rođ.SAD)
Italija
Španija

*Vaterpolisti
Vanja=
Filip=
Slobodan=
Duško=
Nikola=
Andrija=
Marko=
Milan=

Udovičić
Avramović
Rađen
Soro
Filipović
Aleksić
Pijetlović
Prlainović

*Okruzi
Severnobački=
Srednjebanatski=
Južnobanatski=
Kolubarski=
Podunavski=
Braničevski=
Toplički=
Jablanički=

Valjevo
Leskovac
Požarevac
Prokuplje
Subotica
Zrenjanin
Pančevo
Smederevo

*Sportisti
Dejan Bodiroga=
Andrija Gerić=
Dejan Stanković=
Novak Đoković=
Milorad Čavić=
Marko Marjanović=
Filip Filipović=
Aleksandar Karakašević=

Fudbal
Odbojka
Vaterpolo
Stoni tenis
Plivanje
Veslanje
Tenis
Košarka

*Stari zanati
Kujundžija=
Mutavdžija=
Ćurčija=
Dunđer=
Rabadžija=
Sakadžija=
Sajdžija=
Abadžija=

Raznos pitke vode
Zlatar
Pravi odeću od grubog sukna
Teglenje volovima
Tkač
Zidanje nabijanica
Časovničar
Pravi odeću od kože

*Odbojkaši
Đorđe=
Đula=
Andija=
Ivan=
Slobodan=
Vladimir=
Goran=
Vasa=

Batez
Mijić
Mešter
Đurić
Boškan
Miljković
Vujević
Gerić

*Antički mitovi
Argonauti=
Antigona=
Grifon=
Hidra=
Herakle=
Hektor=
Polifem=
Penelopa=

Neman sa 9 glava
Odisejeva žena
Trojanski vojskovođa
Jednooki kiklop
Tragači za zlatnim runom
Edipova ćerka
Biće sa telom lava i orla
Sin boga Zevsa

*Košarkaši
Predrag=
Zoran=
Milenko=
Stefan=
Novica=
Uroš=
Milan=
Miroslav=

Stojaković
Mačvan
Marković
Tripković
Veličković
Tepić
Savić
Raduljica

*Režiseri
Sedam i po=
Život je čudo=
Mi nismo anđeli=
Čalston za Ognjenku=
Klopka=
Lavirint=
Četvrti čovek=
Šejtanov ratnik=

Stevan Filipović
Dejan Zečević
Srdan Golubović
Miroslav Momčilović
Srđan Dragojević
Emir Kusturica
Uroš Stojanović
Miroslav Lekić

*Auto oznake država
Mađarska=H
Honduras=HN
Holandija=NL
Maroko=MA
Crna Gora=MNE
Srbija=SRB
Hrvatska=HR
Kina=CN
#http://en.wikipedia.org/wiki/List_of_international_vehicle_registration_codes

*Poznati ljudi i zanimanja
Ivan Zeljković=
Nikola Radojčić=
Ignjat Jung=
Dragoslav Mitrinović=
Josif Pančić=
Živojin Mišić=
Dragoslav Avramović=
Đorđe Vajfert=

Matematičar
Arheolog
Istoričar
Botaničar
Ekonomista
Vojskovođa
Industrijalac
TV voditelj

*Košarkaši
Aleksandar=
Vlade=
Predrag=
Žarko=
Dejan=
Miloš=
Nenad=
Nemanja=

Đorđević
Krstić
Paspalj
Teodosić
Bodiroga
Danilović
Divac
Bjelica

*Izmi
Alkoholizam=
Abolicionizam=
Alpinizam=
Budizam=
Dadaizam=
Kapitalizam=
Turcizam=
Optimizam=

Planinarenje
Oslobađanje robova
Reč iz turskog jezika
Pozitivan pogled na svet
Umetnički pokret
Ekonomski sistem
Religija
Ovisnost o alkoholu

*Latinski nazivi sazvežđa
Bik=
Blizanci=
Vaga=
Vodolija=
Devica=
Jarac=
Ovan=
Strelac=

Capricornus
Taurus
Sagittarius
Virgo
Gemini
Aquarius
Aries
Libra

*Religije
Hrišćanstvo=
Islam=
Hinduizam=
Budizam=
Džainizam=
Gnosticizam=
Judaizam=
Ateizam=

Mahajanci
Jevreji
Digambari
Muslimani
Pravoslavci
Šaktisti
Bez religije
Bogumili

*Atentatori
Gaj Julije Cezar=Marko Junije Brut
Abraham Linkoln=Džon Vilks But
Karađorđe=Vujica Vulićević
Mahatma Gandi=Naturam Godse
Če Gevara=Mario Teran
Ana Lind=Mijailo Mijailović
Džon Kenedi=Li Harvi Osvald
Franc Ferdinand=Gavrilo Princip
Zoran Đinđić=Zvezdan Jovanović
Martin Luter King=Džejms Erl Rej
Robert Kenedi=Sirhan Sirhan
Džon Lenon=Mark Dejvid Čepmen
#http://sr.wikipedia.org/sr-el/%D0%A1%D0%BF%D0%B8%D1%81%D0%B0%D0%BA_%D0%B0%D1%82%D0%B5%D0%BD%D1%82%D0%B0%D1%82%D0%BE%D1%80%D0%B0

*Autori stripova
Maks i Magnus=Alan Ford
Gošini i Uderco=Asteriks
Bob Kejn=Betmen
EsseGesse=Blek Stena
Džim Dejvis=Garfild
Boneli i Feri=Zagor
Rene Gošini=Talični Tom
Dik Braun=Hogar Strašni

*Nazivi mesta iz perioda starog Rima
Naisus=Niš
Neoplanta=
Singidunum=Beograd
Viminacijum=
Taurunum=Zemun
Kusum=
Semendrija=
Sirmijum=Sremska Mitrovica

Kostolac
Petrovaradin
Smederevo
Novi Sad

*Pozivni brojevi
Beograd=011
Novi Sad=
Požarevac=
Kruševac=
Pančevo=
Zrenjanin=
Valjevo=014
Kraljevo=

013
036
023
037
021
012

*Kompozitori
Johan Sebastijan Bah=
Ludvig van Betoven=
Hektor Berlioz=
Johan Brams=
Đuzepe Verdi=
Đoakino Rosini=
Antonio Vivaldi=
Volgang Amadeus Mocart=

Faustovo prokletstvo
Mesečeva sonata
Godišnja doba
Turski marš
Nabuko
Seviljski berber
Nemački rekvijem
Brandenburški koncerti

*Fobije (strah od)
...vode=akvafobija
...rada=ergofobija
...pasa=kinofobija
...letenja=aerofobija
...zatvorenog prostora=klaustrofobija
...otvorenog prostora=agorafobija
...žena=ginekofobija
...žaba=batrahofobija
...bola=aglofobija
...vožnje=amaksofobija
...muškaraca=androfobija
...cveća=antofobija
...ljudi=antropofobija
...paukova=arahnofobija
...munja=astrafobija
...samoće=autofobija
...sluzi=blenofobija
...nevremena=brontofobija
...govora=glasofobija
...seksa=genofobija
...ludila=dementofobija
...drveća=dendrofobija
...prelaska ulica=dromofobija
...povraćanja=emetofobija
...insekata=entomofobija
...životinja=zoofobija
...raka(bolesti)=karcinofobija
...ružnoće=kakofobija
...stranaca=ksenofobija
...vezivanja=linonofobija
...prljavštine=mizofobija
...bolesti=nekrofobija
...mraka=niktofobija
...brojeva=numerofobija
...golote=nudofobija
...zmija=ofidiofobija
...ptica=omitofobija
...greha=pekatofobija
...vatre=pirofobija
...vozova=siderodromofobija
...jela=sitofobija
...sahranjen živ=tafofobija 
...smrti=tanatofobija
...kose=trihofobija 
...broja 13=triskaidekafobija
...injekcije=tripanofobija
...svetlosti=fotofobija 
...straha=fobofobija 
...duhova=fazmofobija 
...zaljubljivanja=filofobija
...krvi=hemofobija
...gmizavaca=herpetofobija 
#http://www.psihologija.autentik.net/fobije_vrste_fobija.php

*Registarske oznake za automobile
Beograd=BG
Valjevo=VA
Vranje=VR
Vršac=VŠ
Kraljevo=KV
Kragujevac=KG
Pančevo=PA
Paraćin=PN

*Boje
Bela=
Žuta=
Crvena=
Zelena=
Plava=
Crna=
Siva=
Mrka=

Udovica
Kuga
Kapa
Laguna
Štampa
Livada
Ekonomija
Armija

*Reke i gradovi
Šabac=
Senta=
Loznica=
Smederevo=
Zaječar=
Prokuplje=
Varvarin=
Arilje=

Tisa
Morava
Toplica
Dunav
Timok
Drina
Rzav
Sava

*Muzičari i instrumenti
Džimi Hendriks=
Boki Milošević=
Stefan Milenković=
Bora Dugić=
Luj Armstrong=
Elton Džon=
Džon Koltrejn=
Lars Urlih=

Frula
Saksofon
Truba
Klarinet
Gitara
Violina
Bubnjevi
Klavir

*Vitamini
K3=
A1=
B2=
B5=
B6=
K1=
B1=
B
H=
C=

Cijankobalamin
Ftiokol
Tiamin
Riboflavin
Biotin
Pantotenska kiselina
Adermin
Retinol
Askorbinska kiselina
Filohinon

*Bogovi iz rimske mitologije
Apolon=
Jupiter=
Mars=
Minerva=
Neptun=
Pluton=
Venera=
Vesta=
Vulkan=
Uran=

Svetlost
Ljubav i lepota
Srce i brak
Vatra
Podzemni svet
Glavni bog
More
Mudrost
Nebo
Rat

*Glavne uloge u filmovima
Terminator=
Umri muški=
Matrix=
Rambo=
Gorštak=
Plaža=
Hrabro Srce=
Muva=
Dan Nezavisnosti=
Pirati sa Kariba=

Džef Goldblum
Arnold Švarceneger
Mel Gibson
Kianu Rivs
Vil Smit
Silvester Stalone
Kristofer Lambert
Brus Vilis
Džoni Dep
Leonardo DiKaprio

*Pobednici takmičenja za pesmu Evrovizije
Aleksander Ribak=
Dima Bilan=
Marija Šerifović=Srbija
Helena Paparizu=Grčka
Ruslana=Ukrajina
Lordi=
Sertab Erener=Turska
Braća Olsen=
Šarlot Nilson=
Selin Dion=

Norveška
Danska
Švedska
Finska
Rusija
Švajcarska


*Atomski brojevi hemijskih elemenata
Kiseonik - O=
Paladijum - Pd=
Tantal - Ta=
Silicijum - Si=
Litijum - Li=
Ugljenik - C=
Azot - N=
Kalcijum - Ca=
Sumpor - S=
Uranijum - U=

20
8
7
73
16
14
3
46
92
6

*Glavni gradovi
Švedska=
Bugarska=
Italija=
Francuska=
Nemačka=
Norveška=
Finska=
Litvanija=
Estonija=
Češka=

Helsinki
Sofija
Vilnius
Oslo
Škokholm
Pariz
Talin
Prag
Berlin
Rim

*Nazivi meseca u srpskom i hrvatskom jeziku
Januar=
Februar=
Mart=
April=
Jul=
Avgust=
Septembar=
Oktobar=
Novembar=
Decembar=

Veljača
Travanj
Kolovoz
Rujan
Studeni
Listopad
Srpanj
Siječanj
Ožujak
Prosinac

*Hemijske oznake metala
Bakar=
Cink=
Nikl=
Kobal=
Molibden=
Rodijum=
Tantal=
Cirkonijum=
Kadmijum=
Titanijum=

Cu
Ta
Zr
Cd
Rh
Zn
Mo
Co
Ti
Ni

*Filmski glumci i uloge
Prljavi Hari=
Inspektor Kluzo=
Džejms Bond=
Supermen=
Tarzan=
Indijana Džons=
Džon MekLejn=
Neo=
Pobesneli Maks=
Aksel Foli=

Klint Istvud
Edi Marfi
Kianu Rivs
Kristofer Riv
Šon Koneri
Piter Selers
Harison Ford
Džoni Vajsmiler
Brus Vilis
Mel Gibson

*Fudbalski stadioni
Crvena Zvezda=
Barselona=
Mančester Junajted=
Real Madrid=
Arsenal=
Atletiko Madrid=
Čelzi=
Valensija=
Spartak Moskva=
PSG=

Visente Kalderon
Kamp Nou
Stamford Bridž
Old Traford
Santjago Bernabeu
Emirati
Lužni
Mestalja
Marakana
Park Prinčeva

*Kiseline
Sumporna=
Mravlja=
Pantotenska=
Sona=
Folna=
Azotna=
Limunska=
Sirćetna=
Askorbinska=
Niacin=

Vitamin C
Hlorovodonična
Vitamin B9
Vitamin B3
Vitamin B5
Nitratna
Sulfatna
Citratna
Metan
Acetatna

*Merne jedinice
Herz=
Radijan=
Njutn=
Džul=
Vat=
Om=
Farad=
Tesla=
Bekerel=
Celzijus=

Snaga
Temperatura
Električni otpor
Električni kapacitet
Radioaktivnost
Frekvencija
Sila
Ugao
Energija
Jačina magnetnog polja

*Večiti rivali u fudbalu
Partizan=
Olimpijakos=
Real Madrid=
Boca Juniors=
Arsenal=
Slavija=
CSKA=
Ajax=
Bajern=
Inter=

Panatinaikos
River Plate
Sparta
Spartak
Borusija
PSV
Čelzi
Crvena Zvezda
Barselona
Milan

*Sinonimi
Propeler=
Radijator=
Štednjak=
Digitron=
Krčag=
Pećnica=
Džezva=
Bačva=
Limenka=
Pljoska=

Elisa
Lonče
Bure
Konzerva
Rerna
Hladnjak
Vrč
Kalkulator
Buklija
Šporet

*Parovi
Babe i...=
Jedno i...=
Crno i...=
Mlado i...=
Starac i...=
Mrtav i...=
Srp i...=
Mirko i...=
Juče i...=
Prah i...=

Čekić
Beo
Pepeo
Slavko
Žabe
Danas
More
Ludo
Belo
Jedino

*Glavni gradovi
Abudza=
Adis Abeba=
Akra=
Dakar=
Gaborone=
Harare=
Kairo=
Kampala=
Mogadiš=
Rabat=

Etiopija
Senegal
Zimbabve
Egipat
Somalija
Uganda
Bocvana
Nigerija
Gana
Maroko

*Hemijska jedinjenja
Natrijum hlorid=
DNK=
Metanol=
Glukoza=
Hidrogen nitrid=
Vosak=
Hemoglobin=
Holin=
Dihidrogen monoksid=
Metanal=

Estar
Kiselina
Protein
Alkohol
Šećer
Amonijak
Voda
Baza
So
Aldehid

*Težinske kategorije boksera
do 48 kg=papir
do 51 kg=muva
do 54 kg=bantam
do 57 kg=perolaka
do 60 kg=laka
do 64 kg=poluvelter
do 69 kg=velter
do 75 kg=srednja
do 81 kg=poluteška
do 91 kg=teška
od 91 kg=superteška
#http://sr.wikipedia.org/sr-el/%D0%91%D0%BE%D0%BA%D1%81

*Računarske aplikacije i primena
Windows=operativni sistem
Photoshop=obrada slika
Word=obrada teksta
Firefox=pregled internet sajtova
Dreamweaver=izrada Internet sajtova
PowerPoint=izrada prezentacija
Excel=tabelarna proračunavanja
Adobe Reader=prikaz PDF dokumenata
ICQ=slanje instant poruka
Thunderbird=elektronska pošta

*Književnici i dela
Đura Jakšić=
Jovan Jovanović Zmaj=
Aleksa Šantić=
Vasko Popa=
Jovan Dučić=
Vladislav Petković Dis=
Petar Petrović Njegoš=Gorski Vijenac
Ljubivoje Ršumović=
Radoje Domanović=
Zaharije Orfelin=

Utopljene duše
Žitije Petra Velikog
Braću ne donose rode
Stanoje Glavaš
Mrtvo more
Plave legende
Kuća na sred druma
Hasanaginica
Đulići

*Bogovi iz grčke mitologije
Uran=
Geja=
Zevs=
Dionis=
Anatola=
Ejrena=
Posejdon=
Artemida=
Afrodita=
Atina=

More
Mir
Mudrost
Mesec i lov
Nebo
Lepota i ljubav
Proleće
Vino
Munje
Zemlja

*Merne jedinice
Inč=
Stopa=
Kopnena milja=
Nautička milja=
Funta=
Hvat=
Parsek=
Svetlosna godina=
Pinta=
Unca=

9461 milijardi km
2,54 cm
30857 milijardi km
1609 m
473 ml
1852 m
459,59 g
30,48 cm
28,35 g
1,896 m

*Filmovi o Džejmsu Bondu i godine
Dr. No=
Live and Let Die=
For Your Eyes Only=
A View to a Kill=
The World Is Not Enough=
Casino Royale=
From Russia with Love=
Diamonds Are Forever=
The Man with the Golden Gun=
GoldenEye=

1974
1962
1995
1999
2006
1973
1985
1963
1981
1971

*Glavni gradovi
Belmopan=
Buenos Aires=
Karakas=
Kingston=
La Paz=
Lima=
Montevideo=
Paramaribo=
Brazilija=
Santjago=

Argentina
Jamajka
Peru
Urugvaj
Brazil
Surinam
Bolivija
Belize
Venecuela
Čile

*Sedišta kompanija proizvođača sportske opreme
Nike=
Diadora=
Lacoste=
Lotto=
Reef=
Adidas=
Champion=
Speedo=
Elan=
Umbro=

Bondi Beach, Australija
Portland, SAD
Winston-Salem, SAD
Pariz, Francuska
Begunje, Slovenija
Treviso, Italija
San Diego, SAD
Giavera del Montello, Italija
Cheadle, Velika Britanija
Herzogenaurach, Nemačka

*Latinski nazivi životinja
Tigar=
Hrčak=
Morsko prase=
Veverica=
Kengur=
Jež=
Hijena=
Nilski konj=
Koala=
Golub=

Cavia porcellus
Hyaena
Panthera Tigris
Sciurus
Hippopotamus
Cricetus
Macropus
Erinaceus
Phascolarctos
Columba

*Članovi ekipe SAD na olimpijadi 2008 i klubovi gde su tada igrali
Carlos Boozer=
Jason Kidd=
LeBron James=
Dwyane Wade=
Kobe Bryant=
Dwight Howard=
Chris Bosh=
Chris Paul=
Tayshaun Prince=
Carmelo Anthony=

Detroit Pistons
Miami Heat
Los Angeles Lakers
Denver Nuggets
Cleveland Cavaliers
Orlando Magic
Utah Jazz
Toronto Raptors
Dallas Mavericks
New Orleans Hornets

*Ženske uloge u filmovima o Džejms Bondu
Dr. No=
Die Another Day=
The World Is Not Enough=
GoldenEye=
Live and Let Die=
Casino Royale=
Tomorrow Never Dies=
Licence to Kill=
Octopussy=
For Your Eyes Only=

Sophie Marceau
Michelle Yeoh
Ursula Andress
Izabella Scorupco
Carey Lowell
Halle Berry
Jane Seymour
Ivana Miličević
Maud Adams
Carole Bouquet

*Predatori i plen
Zmija=
Mačka=
Gepard=
Bogomoljka=
Soko=
Ajkula=
Orka=
Lav=
Lisica=
Vuk=

Kokoška
Pčela
Zec
Ovca
Antilopa
Ribe
Žaba
Ajkule
Miš
Zebra

*Latinski nazivi biljaka
Quercus=
Tilia=
Castanea=
Pinus=
Abies=
Acer=
Fraxinus=
Juglans=
Robinia=
Populus=

Jela
Topola
Javor
Jasen
Bagrem
Hrast
Kesten
Lipa
Bor
Orah

*Antonimi
Crno=
Sladak=
Visok=
Lep=
Pametan=
Okrugao=
Dug=
Širok=
Svetla=
Jako=

Tamna
Belo
Slabo
Glup
Ćoškast
Gorak
Ružan
Kratak
Nizak
Uzak

*Kompanije i sedišta
Sintelon=
Severtrans=
Simpo=
AIK Banka=
Albus=
Aleva=
ATB Sever=
Autobanat=
Banini=
Zastava automobili=

Subotica
Sombor
Zrenjanin
Novi Kneževac
Bačka Palanka
Niš
Kikinda
Kragujevac
Novi Sad
Vranje

*Predsednici SAD (početna godina)
1789=
1801=
1861=
1901=
1945=
1953=
1961=
1969=
1981=
1993=

Džordž Vašington
Džon Kenedi
Ričard Nikson
Ronald Regan
Dvajt Ajzenhauer
Tomas Džeferson
Hari Truman
Teodor Ruzvelt
Bil Klinton
Abraham Linkoln

*Proizvođači uređaja
XBox=
PlayStation=
Wii=
Jaguar=
Mega Drive=
Odyssey=
Amiga=
iPod=
Neo 1973=
EEE PC=

Sega
Asus
MagnaVox
Commodore
Openmoko
Microsoft
Nintendo
Sony
Atari
Apple

*Glavni gradovi
Irak=
Azerbejdžan=
Iran=
Liban=
Sirija=
Jermenija=
Saudijska Arabija=
Libija=
Uzbekistan=
Afganistan=

Damask
Kabul
Jerevan
Rijad
Taškent
Bagdad
Teheran
Baku
Bejrut
Tripoli

*Biljke i familije u koje spadaju...
Hrast=
Kokos=
Cimet=
Lipa=
Smokva=
Jasen=
Breskva=
Topola=
Sekvoja=
Ariš=

Bukve
Ruže
Vrbe
Čempresi
Masline
Palme
Dudovi
Slezovi
Borovi
Lovori

*Sokovi i proizvođači
Fanta=
Mirinda=
Guarana=
Bravo=
Next=
Cockta=
Fructal=
Frutini=
Ritam=
Biter Lemon=

Nektar
Šveps
Coca Cola
Fresh
Moć Prirode
Kolinska
Knjaz Miloš
Fructal
Rauch
Pepsi

*Novac
SAD=
Srbija=
Velika Britanija=
Argentina=
Bugarska=
Estonija=
Kenija=
Mađarska=
Hrvatska=
Vijetnam=

Šiling
Kruna
Dong
Forinta
Dolar
Kuna
Lev
Pezos
Funta
Dinar

*Glavni gradovi
Tajland=
Indonezija=
Pakistan=
Malezija=
Filipini=
Japan=
Novi Zeland=
Severna Koreja=
Južna Koreja=
Vijetnam=

Seul
Bangkok
Hanoj
Manila
Tokio
Džakarta
Kuala Lumpur
Velington
Islamabad
Pjongjang

*NBA ekipe i gradovi
Lakers=
Bulls=
Spurs=
Heat=
Rockets=
Magic=
Pistons=
Pacers=
Nets=
Mavericks=

New Jersey
Miami
Houston
Dallas
San Antonio
Orlando
Los Angeles
Detroit
Chicago
Indiana

*Proizvođači računarskih igara
Pac-man=
Counter Strike=
Quake=
Super Mario=
Mortal Combat=
Tomb Raider=
Grand Theft Auto=
World of Warcraft=
The Sims=
NBA Live=

Blizzard
Electronic Arts
Namco
Midway
Maxis
Core Design
Id Software
Rockstar
Nintendo
Valve

*Letovališta
Kušadasi=Turska
Ibica=Španija
Hurgada=Egipat
Hvar=Hrvatska
Budva=Crna Gora
Kavala=Grčka
Kan=Francuska
Portorož=Slovenija
Rimini=Italija
Agadir=Maroko

*Proizvođači lekova
Bensedin=
Andol=
Ranisan=
Tamiflu=
Hemomycin=
Aspirin=Bayer
Viagra=
Septolete=
Coldrex=
Caffetin=

Glaxo Smith Kline
Galenika
Alkaloid
Hemofarm
Pliva
Roche
Pfizer
Zdravlje
Krka

*Šon Koneri - filmovi i uloge
Dr. No=
Murder on the Orient Express=
First Knight=
Indiana Jones and the Last Crusade=
Highlander=
The Rock=
A Good Man in Africa=
Entrapment=
Finding Forrester=
The Hunt for Red October=

Doktor Alex Murray
Begunac iz Alkatraza John Mason
Kapetan podmornice Marko Ramius
Kradljivac Robert MacDougal
Tajni agent James Bond
Pisac William Forrester
Vitez Juan Ramirez
Profesor Henry Jones Stariji
Kralj Arthur
Pukovnik Arbuthnot

*Sinonimi
Hodati=
Morski pas=
Šija=
Zelen=
Stomak=
Bure=
Ekser=
Faktura=
Maramica=
Lestve=

Bačva
Trbuh
Merdevine
Vrat
Peršun
Džepnica
Račun
Ajkula
Pešačiti
Klin

*Mladunci životinja
Ovca=
Koza=
Kokoška=
Krava=
Košuta=
Mačka=
Pas=
Patka=
Medved=
Ćurka=

Kuče
Jare
Pače
Mače
Jagnje
Tele
Meče
Ćure
Lane
Pile

*Naslovi filmova
Maratonci trče=počasni krug
Ko to tamo=peva
Povratak u=budućnost
Niske=strasti
Devojka od milion=dolara
Blistavi=um
Američka=lepota
Engleski=pacijent
Razum i=osećajnost
Ples sa=vukovima

*Pića i zemlje
Šljivovica=Srbija
Metaksa=Grčka
Votka=Rusija
Viski=Škotska
Pivo=Češka
Rum=Jamajka
Tekila=Meksiko
Sake=Japan
Šampanjac=Francuska
Akvavit=Norveška

*Reke i ušća...
Amazon=
Nil=
Jangce=
Misisipi=
Niger=
Volga=
Dunav=
Visla=
Eufrat=
Kolumbija=

Crno More
Sredozemno More
Baltičko More
Kaspijsko More
Atlanski Okean
Meksički Zaliv
Persijski Zaliv
Pacifik
Gvinejski Zaliv
Istočno Kinesko More

*Saobraćajni znaci i boje
Stop=
Put sa prvenstvom prolaza=
Parking=
Pešački prelaz=
Ograničenje brzine=
Zabranjeno parkiranje=
Slepa ulica=
Ulazak na autoput=
Raskrsnica=
Zabrana saobraćaja=

Crvena, bela
Žuta, bela
Žuta, crna
Crvena, plava
Crvena, žuta
Plava, bela
Crvena, bela, plava
Crvena, žuta, crna
Zelena, bela
Plava, bela, crna

*Modeli automobila i proizvođači
Volkswagen=
Ford=
Toyota=
Kia=
Dacia=
Opel=
Fiat=
Citroen=
Seat=
Škoda=

Toledo
Polo
Fabia
Solenza
Vectra
Focus
Picanto
Punto
Yaris
Xsara

*Imena i prezimena glumaca...
Ričard=
Arnold=
Tom=
Brus=
Kianu=
Met=
Robert=
Kirk=
Kevin=
Nikolas=

Dejmon
Švarceneger
De Niro
Henks
Vilis
Rivs
Spejsi
Daglas
Gir
Kejdž

*Pojmovi i značenja
Karburator=
Daždevnjak=
Kamila=
Karakondžula=
Frižider=
Rižoto=
Singapur=
Pelikan=
Dan=
Čekić=

Vremenski period
Čudovište
Bela tehnika
Alat
Sisar
Hrana
Deo automobila
Grad
Vodozemac
Gumica za brisanje

*Američke države i gradovi
Arizona=Phoenix
Californija=Los Angeles
Colorado=Denver
Florida=Miami
Texas=Houston
Ilinois=Chicago
Oregon=Portland
Minnesota=Minneapolis
Michigan=Detroit
Louisiana=New Orleans

*Sportski tandemi
Majkl Džordan=
Predrag Danilović=
Vladimir Grbić=
Kobi Brajant=
Medžik Džonson=
Daniel Nestor=
Ronaldinjo=
Denis Šefik=
Karl Melon=
Pele=

Aleksandar Đorđević
Eto
Nikola Grbić
Karim Abdul Džabar
Skoti Pipen
Garinča
Šejkil O'Nil
Nenad Zimonjić
Džon Stokton
Nikola Kuljača

*Oznake hemijskih elemenata
Vodonik=H
Kiseonik=O
Ugljenik=C
Azot=N
Zlato=Au
Srebro=Ag
Gvožđe=Fe
Olovo=Pb
Kalijum=K
Kalcijum=Ca

*Pisci i dela
20000 milja pod morem=Vern
Alisa u zemlji čuda=Kerol
Ana Karenjina=Tolstoj
Božanstvena komedija=Dante
Evgenije Onjegin=Puškin
Guliverova putovanja=Svift
Hamlet=Šekspir
Ilijada=Homer
Na Drini ćuprija=Andrić
Proces=Kafka

*Rimski brojevi
651=
1718=
3642=
432=
2222=

549=
233=
7
1234=

XII
MDCCXVIII
DXLIX
MMMDCXLII
CDXXXII
MMCCXXII
DCCXII
CCXXXIII
DCLI
MCCXXXIV

*Fabrike automobila i gradovi
Ford=
Volksvagen=
Tojota=
BMW=
Citroen=
Fiat=
Zastava=
Peugeot=
Suzuki=
Ferari=

Tokio
Kragujevac
Detroit
Minhen
Sošo
Volfsburg
Pariz
Torino
Hirošima
Maranelo

*Planine i države
Himalaji=Nepal
Kilimandžaro=Tanzanija
Apalači=Kanada
Durmitor=Crna Gora
Alpi=Švajcarska
Sierra Madre=Filipini
Ural=Rusija
Pirin=Bugarska
Sierra Morena=Španija
Tatre=Slovačka

*Junaci crtanih filmova
Tom=Džeri
Miki Maus=Paja Patak
Štrumfovi=Gargamel
Pera Kojot=Ptica trkačica
Stanlio=Olio
Krava=Pile
Dekster=Di Di
Nodi=Marta
Asteriks=Obeliks
Fred Kremenko=Vilma

*Glavni gradovi
Srbija=Beograd
Mađarska=Budimpešta
Vietnam=Hanoi
Severna Koreja=Pjongjang
Austrija=Beč
Švajcarska=Bern
Francuska=Pariz
Brazil=Brazilija
Čile=Santjago
Peru=Lima

*Gradovi i njihovi nekadašnji nazivi
Nju Jork=Nju Amsterdam
Otava=Bajtaun
Tel Aviv=Jafa
Toronto=Jork
Vinipeg=Fort Geri
Ankara=Angora
Teheran=Raj
Almati=Alma Ata
Kalkuta=Fort Vilijem
Aman=Filadelfija
Izmir=Smirna

*Gradovi i njihovi nekadašnji nazivi
Jangon=Rangun
Guangdžou=Kanton
Džakarta=Batavija
Čenaj=Madras
Mumbaj=Bombaj
Tokio=Edo
Seul=Hanseong
Ho Ši Min=Sajgon

*Gradovi i njihovi nekadašnji nazivi
Sankt Peterburg=Lenjingrad
Dušanbe=Staljinabad
Volgograd=Carcin
Samara=Kujbišev
Kalinjingrad=Kenigsberg
Kučand=Lenjinabad
Kirov=Vjatka
Jekaterinburg=Sverdlovsk
Činvali=Staljiniri
Nižnji Novgorod=Gorki

*Gradovi i njihovi nekadašnji nazivi
Durban=Port Natal
Maputo=Lorenso Markeš
Kinšasa=Leopoldvil
Ndžamena=Fort Lami
Harare=Solzberi
Polokvane=Petersburg
Tripoli=Oea
Santo Domingo=Sijudad Truhiljo
Sjudad de Mehiko=Tenočtitlan

*Gradovi i njihovi nekadašnji nazivi
Vroclav=Breslau
Trondhejm=Nidaros
Oslo=Kristijanija
Lion=Lugdunum
Pariz=Lutecija
Talin=Reval
Klajpeda=Memel
Istanbul=Konstantinopolj

*Gradovi i njihovi nekadašnji nazivi
Gdanjsk=Dancig
Brašov=Orasul Stalin
Bratislava=Požun
Kemnic=Karl Marks Štat
Lavov=Lemberg
Sofija=Serdika
Katovice=Staljinogrod
Liberec=Rajhenberg
Karlovi Vari=Karlsbad

*Gradovi i njihovi nekadašnji nazivi
Podgorica=Titograd
Berane=Ivangrad
Zagreb=Agram
Osijek=Mursa
Dubrovnik=Raguza
Split=Spalatum
Šibenik=Sebeniko
Zadar=Zara
Ljubljana=Emona
Rijeka=Fjume

*Gradovi i njihovi nekadašnji nazivi
Šabac=Zaslon
Kladovo=Fetislam
Zrenjanin=Bečkerek
Ćuprija=Ravno
Kraljevo=Rankovićevo
Jagodina=Svetozarjevo
Niš=Nais
Beograd=Singidunum
Zemun=Taurunum
Sremska Mitrovica=Sirmijum

*Sadašnja i stara imena država
Bocvana=Bečuana
Češka=Bohemija
Iran=Perzija
Jordan=Transjordan
Irak=Mezopotamija
Izrael=Britanska Palestina
Meksiko=Nova Španija
Moldavija=Besarabija

*Sadašnja i stara imena država
Belize=Britanski Honduras
Bolivija=Gornji Peru
Kolumbija=Nova Granada
Ekvatorijalna Gvineja=Španska Gvineja
Gvineja Bisau=Portugalska Gvineja
Australija=Nova Holandija
Bangladeš=Istočni Pakistan
Benin=Dahomej

*Sadašnja i stara imena država
Alžir=Numidija
Etiopija=Abisinija
Gana=Zlatna obala
Kiribati=Gilbertova ostrva
Namibija=Nemačka jugozapadna Afrika
Lesoto=Basuto
Malavi=Njasaland
Džibuti=Francuska Somalija

*Sadašnja i stara imena država
Gvajana=Britanska Gvajana
Surinam=Holandska Gvajana
Mali=Francuski Sudan
Zambija=Severna Rodezija
Zimbabve=Južna Rodezija
Zaire=Belgijski Kongo
Burkina Faso=Gornja Volta
Centralnoafrička Republika=Ubangi-Šari

*Sadašnja i stara imena država
Indonezija=Holandska istočna Indija
Filipini=Španska istočna Indija
Singapur=Temasek
Šri Lanka=Cejlon
Tajland=Sijam
Burma=Mijanmar
Tajvan=Formoza
Kambodža=Kampučija

*Srpske reči latinskog izvora na slovo F
fabula=priča
favor=naklonost
favus=saće meda
faksimil=verna kopija
faktotum=onaj koji sve radi
fakula=buktinja
falacija=prevara
fama=glas,vest
famulus=sluga
farina=brašno

*Srpske reči latinskog izvora na slovo F
fauna=životinjski svet
facinus=nedelo, zločin
fel=žuč
feliks=srećan
fervidan=vreo
ferum=gvožđe
festum=svetkovina
fetus=zametak
fidelan=veran, čestit
fiks=čvrst

*Srpske reči latinskog izvora na slovo F
finis=kraj
firmitet=čvrstina
fisura=rascep
flora=biljni svet
flos=cvet
floskula=fraza
fluid=tečnost
fokus=ognjište
folijum=list
fosa=jama, rupa
fanatik=zanesenjak

*Srpske reči grčkog izvora na slovo F
fakoliza=oslobođenje
fantazija=mašta
farinks=ždrelo
farmakon=lek
fenomen=pojava
filakterij=stražara
fitofag=biljojed
flegma=sluz
fobija=strah
fon=glas
foton=svetlosni kvant
fraza=izraz
faza=stupanj u procesu menjanja
	
*Srpske reči italijanskog izvora na slovo F
freta=žurba, naglost
fagot=drveni muzički instrument
faliment=stečaj
fango=blato, glib
feferon=mala ljuta paprika
freska=slika na svežem malteru
fol=laž,varka
faca=lice
fileti=tanke trake ribljeg mesa
finta=prevara, lukavstvo
fregata=vrsta broda
	
*Germanizmi na slovo F
fraj=slobodan, besplatan
frišak=svež
froncla=resa
frtalj=četvrtina
fruštuk=doručak
fušer=čovek koji radi površno
fajront=prestanak rada
fajn=tanak, nežan
falta=bora, nabor
fah=struka
felčer=vojni bolničar
feler=mana
feršter=šumar
firanga=zavesa
flinta=žena lakog morala

*Srpske reči engleskog izvora na slovo F
faktorija=fabrika
fan=obožavalac
fender=odbojnik na brodu
fer=pošten, častan
feribot=trajekt
fidbek=skup povratnih informacija
finiš=kraj
flert=udvaranje
flint=kremen
forhend=udarac u tenisu
	
*Srpske reči francuskog izvora na slovo F
fondan=	preliv za kolače
fanfara=limeni duvački instrument
farsa=lakrdija, šala
fasada=glavni izgled građevine
fezer=izazivač političkih nemira
feljton=stalna rubrika u novinama
fetiš=stvar kojoj se pripisuje čarolija
fijaker=kočija
filigran=umetnički rad od zlatne žice
finesa=tananost
fiša=cedulja

*Srpske reči francuskog izvora na slovo F
flakon=bočica za parfem
flanel=vrsta tkanine
foaje=predvorje
fondan=glavnica
fors=sila, snaga
fotelja=udobna stolica
frapantan=upadljiv
frotoar=krpa
fugasa=nagazna mina
fular=vrsta svile
	
*Poreklo srpskih reči stranog izvora na F
fjord=dansko
fleka=nemačko
ferman=persijsko
ferment=latinsko
film=englesko
fioka=mađarsko
fitilj=tursko
front=francusko
finta=italijansko
fobija=grčko
	
*Srpske reči mađarskog izvora
firc=konac za prošivanje
fioka=kutija na izvlačenje
fela=vrsta, soj
cukor=šećer
hajduk=lako naoružan pešak
hintov=kočije, karuce
čaklja=motka sa gvozdenom kukom
čarda=krčma na drumu
čajka=vrsta čamca
čeze=polufijaker

*Ljubav prema...
sebi (samoljublje)=filautija
srebru (srebroljublje)=filargirija
mudrosti=filozofija
deci=filogonija
ženi=filoginija
strancima=filoksenija
onome što je lepo=filokalija
književnosti=filologija
domovini=filopatrija
piću=filopozija

*Germanizmi na slovo H
havarija=kvar
hauba=poklopac motora
haustor=velika vrata, ulaz
helebrada=srednjevekovno oružje
hemung=prepreka, smetnja
herc=srce
hercig=mio, umiljat
hilzna=čaura metka
hohštapler=prevarant
horn=rog

*Srpske reči grčkog izvora na H
hazma=ponor
hama=zamka
haos=zbrka
harizma=milosni dar
harmonija=sklad
hegemon=neograničeni gospodar
heksaedar=kocka
heliks=spirala
helotija=ropstvo
hematom=krvni otok

*Srpske reči grčkog izvora na H
hemisfera=polulopta
henotičan=ujednačen
hentagon=sedmougao
heroj=junak
heteroza=promena, izmena
hidatoza=vodena bolest
hidrant=ulična vodena slavina
hidrosfera=vodeni omotač zamlje
himna=pohvalna pesma
hipodam=ukrotilac konja

*Srpske reči grčkog izvora na H
hipoteka=zalog
hipokrizija=licemerstvo
hipoteza=pretpostavka
homeoza=poređenje
homuzija=istovetnost
hrematopeja=zarađivanje novca
hrezmologija=proricanje
hroma=boja
hronika=letopis
hronos=vreme

*Poreklo srpskih reči stranog izvora na slovo H
hagada=hebrejsko
hangar=francusko
harakiri=japansko
harlekin=italijansko
harpun=englesko
haustor=nemačko
horor=latinsko
hintov=mađarsko
hunta=špansko
hronos=vreme

*Srpske reči latinskog izvora na slovo H
habitus=izgled, ponašanje
heres=naslednik
haustus=gutljaj
herba=latinsko
heroina=junakinja
hominid=najstarije ljudsko biće
homicid=ubistvo
homo=čovek
hospic=svratište
humidan=vlažan

*Turcizmi na slovo H
haber=vest
hazna=blagajna,kesa
hair=sreća
hajvan=stoka, životinja
hakim=mudrac
han=svratište
hanuma=gospođa
handžar=kratki mač

*Turcizmi na slovo H
haps=zatvor
haram=greh
haramija=razbojnik, kradljivac
hasna=korist
hećim=lekar
hila=lukavstvo, prevara
hir=samovolja
hisardžik=gradić

*Srpske reči stranog izvora na slovo C
cadik=pravednik, učitelj
cajger=kazaljka na časovniku
ceger=korpa
cukor=šećer
ceka=kovnica novca
cokule=teške kožne cipele
cizeler=rezač metala
cigara=umotani duvanski listovi
ciklon=oluja
cifra=brojka

*Srpske reči stranog izvora na slovo Č
čaj=napitak od biljke
čarter=povelja,povlastica
čemadan=sanduk za haljine
čerek=četvrtina
čiveterija=koketiranje
čikoš=čuvar konja
činija=zdela
čekrk=točak
čukur=rupa
čaklja=motka sa gvozdenom kukom

*Srpske reči latinskog izvora na C
celofan=tanka plastična masa
centum=stotina
cerat=vosak
cesija=ustupanje
cedulja=parče hartije
cibarije=hrana
circinus=šestar
cirus=paperjasti oblak
cirkulus=krug
civis=građanin

*Turcizmi na slovo Č
čair=livada
čakija=džepni nož
čakmak=kresivo
čakšire=pantalone
čalgija=svirka
čanak=drvena činija
čaršav=stoljnjak
čatrlja=sirotinjska kuća
čelebija=gospodin
čekrk=točak

*Turcizmi na slovo Č
čibuk=cev za lulu
čivit=indigo plava boja
čirak=svećnjak
čitluk=poljsko imanje
čifte=par
čifčija=zemljoradnik
čutura=pljosnata boca
čukur=rupa
čoban=pastir
čengija=igračica
čengel=gvozdena kuka

*Turcizmi na slovo DŽ
džada=put
džambas=ljubitelj konja
džan=duša
džanarika=vrsta šljive
džebana=barut
dželebdžija=trgovac stokom
dželep=čopor goveda
džemijet=društvo
dživar=predgrađe
džimrija=cicija
džidža=dečija igračka
džumbus=nered
džumle=svi zajedno

*Valute
Brazil=real
Argentina=pezos
Švedska=kruna
Češka=kruna
Švajcarska=franak
Hrvatska=kuna
Rumunija=lej
Poljska=zlot
Velika Britanija=funta
Albanija=lek
Bugarska=lev

*Valute
Tanzanija=šiling
Uzbekistan=sum
Kina=juan
Japan=jen
Kuvajt=dinar
Azerbejdžan=manat
Kuba=pezos
Ukrajina=grivna

*Ples i poreklo
saltarelo=italija
flamenko=španija
mambo=kuba
fokstrot=amerika
kolo=srbija
valcer=austrija
poloneza=poljska
tamzara=jermenija
kankan=francuska
sirtaki=grčka
fado=portugal

*Ples i poreklo
fandango=španija
franseza=francuska
tarantela=italija
tango=argentina
rumba=kuba
samba=brazil
čarlston=amerika
mazurka=poljska
marinera=peru
fandango=portugal
kalinka=rusija

*Ples i poreklo
forlana=italija
paso doble=španija
čardaš=mađarska
polka=češka
šota=albanija
kočari=jermenija
gavot=francuska
ča-ča-ča=kuba
džig=škotska
čoček=srbija
hula=havaji
#http://en.wikipedia.org/wiki/List_of_ethnic,_regional,_and_folk_dances_sorted_by_origin

*Opere
Verdi=Nabuko
Mocart=Figarova ženidba				
Vagner=Zigfrid
Pučini=Toska
Rosini=Seviljski berberin				
Belini=Norma
Čajkovski=Pikova dama
Rimski-Korsakov=Besmrtni Kaščej

*Opere
Verdi=Rigoleto
Mocart=Čarobna frula			
Pučini=Boemi
Čajkovski=Evgenije Onjegin
Vagner=Tristan i Izolda
Pučini=Madam Baterflaj
Musorgski=Boris Godunov
Rimski-Korsakov=Bajka cara Saltana

*Opere
Verdi=Aida
Pučini=Turandot
Betoven=Fidelio
Maskanji=Kavalerija Rustikana
Rosini=Viljem Tel
Vagner=Valkira
Bize=Karmen
Veber=Čarobni strelac

*Nobelovci književnici
Sili Pridom=Francuska
Teodor Momzen=Nemačka
Henrik Sjenkjevič=Poljska
Radjard Kipling=Velika Britanija
Vilijam Batler Jejts=Irska
Luiđi Pirandelo=Italija
Ernest Hemingvej=SAD
Boris Pasternak=SSSR

*Nobelovci književnici
Džordž Bernard Šo=Irska
Tomas Man=Nemačka
Perl Bak=SAD
Vinston Čerčil=Velika Britanija
Mihail Šolohov=SSSR
Alber Kami=Francuska
Orhan Pamuk=Turska
Isak Baševis Singer=Poljska

*Nobelovci književnici
Žan-Pol Sartr=Francuska
Herman Hese=Nemačka
Samjuel Beket=Irska
Aleksandar Solženjicin=SSSR
Rabindranat Tagore=Indija
Knut Hamsun=Norveška
Ivo Andrić=Jugoslavija
Harold Pinter=Velika Britanija
Oktavio Paz=Meksiko
Gabrijel Garsija Markes=Kolimbija
Žoze Saramago=Portugal
Pablo Neruda=Čile
Mario Vargas Ljosa=Peru

*Pesme
Milutin Bojić=Plava grobnica
Vladislav Petković Dis=Možda spava
Milan Rakić=Dolap
Veljko Petrović=Ratar
Aleksa Šantić=O, klasje moje
Jovan Dučić=Zalazak sunca
Vojislav Ilić=U poznu jesen
Sima Pandurović=Biserne oči
Stevan Luković=U pozni čas dana
Desanka Maksimović=Predosećanje

*Ruski pisci i njihova dela
Šolohov=Tihi Don
Gogolj=Mrtve duše
Turgenjev=Očevi i deca
Tolstoj=Ana Karenjina
Ljermontov=Junak našeg doba
Dostojevski=Zločin i kazna
Čehov=Galeb
Puškin=Ruslan i Ljudmila

*Ruski pisci i njihova dela
Dostojevski=Idiot
Tolstoj=Uskrsnuće
Bulgakov=Majstor i Margarita
Pasternak=Doktor Živago
Gončarov=Oblomov
Puškin=Jevgenij Onjegin
Solženjicin=Arhipelag Gulag
Iljf i Petrov=Zlatno tele

*Ruski pisci i njihova dela
Dostojevski=Braća Karamazovi
Čehov=Ujka Vanja
Tolstoj=Rat i mir
Gogolj=Revizor
Šolohov=Uzorana ledina
Solženjicin=Odeljenje za rak
Nabokov=Lolita
Puškin=Kavkaški zatvorenik

*Junaci ruskih romana
Tihi Don=Grigorije Melehov
Uzorana ledina=Semjon Davidov
Mrtve duše=Pavel Čičikov
Revizor=Anton Antonovič
Očevi i deca=Jevgenij Bazarov
Rat i mir=Nataša Rostova
Ana Karenjina=Aleksej Vronski
Junak našeg doba=Grigorij Pečorin
Uskrsnuće=Dmitrij Ivanovič Nehljudov
Zločin i kazna=Radion Raskoljnjikov
Braća Karamazovi=Katerina Verhovceva
Idiot=Knez Miškin
Poniženi i uvređeni=Nikolaj Ihmenev
Galeb=Irina Arkadina
Ujka Vanja=Vojnicki

*Junaci poznatih književnih dela
Crveno i crno=Žilijen Sorel
Gospođa Bovari=Ema Ruo
Tvrdica=Harpagon
Čarobni breg=Hans Kastorp
Stranac=Merso
Proces=Jozef K.
Starac i more=Santijago
Zov divljine=Džon Tornton
Zvonar Bogorodične crkve=Kvazimodo
Faust=Mefistofel
Čiča Gorio=Ežen de Rastinjak

*Poznata književna dela
Stendal=Crveno i crno
Flober=Gospođa Bovari
Molijer=Tvrdica
Tomas Man=Čarobni breg
Alber Kami=Stranac
Franc Kafka=Proces
Ernest Hemingvej=Starac i more
Džek London=Zov divljine
Viktor Igo=Zvonar Bogorodične crkve
Gete=Faust
Onore de Balzak=Čiča Gorio

*Književna dela
Milovan Glišić=Glava šećera
Laza Lazarević=Prvi put s ocem na jutrenje
Janko Veselinović=Hajduk Stanko
Svetolik Ranković=Gorski car
Stevan Sremac=Zona Zamfirova
Jakov Ignjatović=Večiti mladoženja
Branislav Nušić=Hajduci
Petar Kočić=Jazavac pred sudom
Bora Stanković=Nečista krv
Miloš Crnjanski=Seobe

*Književna dela	
Stevan Sremac=Ivkova slava
Miroslav Krleža=Gospoda Glembajevi
Meša Selimović=Derviš i smrt
Ivo Andrić=Prokleta avlija
Dobrica Ćosić=Koreni
Danilo Kiš=Rani jadi
Dušan Kovačević=Balkanski špijun
Slobodan Selenić=Ubistvo s predumišljajem
Milorad Pavić=Unutrašnja strana vetra
Aleksandar Tišma=Upotreba čoveka

*Junaci književnih dela
Glava šećera=Radan Radanović
Prvi put s ocem na jutrenje=Trgovac Mitar
Hajduk Stanko=Zavrzan
Gorski car=Gazda Đorđe
Zona Zamfirova=Mane Kujundžija
Večiti mladoženja=Sofra Kirić
Ivkova slava=Kurjak
Hajduci=Žika Dronja
Jazavac pred sudom=David Štrbac
Nečista krv=Sofka

*Junaci književnih dela	
Seobe=Vuk Isaković
Gospoda Glembajevi=Barunica Kasteli
Derviš i smrt=Ahmed Nurudin
Prokleta avlija=Ćamil-efendija
Koreni=Aćim Katić
Rani jadi=Andreas Sam
Balkanski špijun=Ilija Čvorović
Ubistvo s predumišljajem=Bogdan Bilogorac
Unutrašnja strana vetra=Leander
Upotreba čoveka=Nemanja Lazukić
	
*Pobednici formule 1
2010=Sebastijan Fetel
2009=Dženson Baton
2008=Luis Hamilton
2007=Kimi Raikonen
2005=Fernando Alonso
2000=Mihael Šumaher
1998=Mika Hakinen
1997=Žak Vilnev
1996=Dejmon Hil
1993=Alen Prost
1991=Ajrton Sena
1984=Niki Lauda
1981=Nelson Pike

